Rooms,Bathroom,Landsize,Lattitude,Longtitude,Price_original,y_pred_DT,y_pred_NN,Error_DT,Error_NN
2,1,156,-37.8079,144.9934,1035000,2248000,221644272,1213000,220609272
3,2,134,-37.8093,144.9944,1465000,2248000,207217968,783000,205752968
4,1,120,-37.8072,144.9941,1600000,2248000,195926272,648000,194326272
3,2,245,-37.8024,144.9993,1876000,2248000,294943328,372000,293067328
2,1,256,-37.806,144.9954,1636000,2248000,300675200,612000,299039200
2,1,220,-37.801,144.9989,1097000,2248000,272225984,1151000,271128984
3,2,214,-37.8085,144.9964,1350000,2248000,270443008,898000,269093008
2,2,0,-37.8078,144.9965,750000,835500,99952864,85500,99202864
2,1,238,-37.809,144.9976,1310000,2248000,286451520,938000,285141520
3,2,113,-37.8056,144.993,1200000,2248000,190620384,1048000,189420384
3,1,138,-37.8021,144.9965,1176500,2248000,208786336,1071500,207609836
2,1,150,-37.8011,145.0004,890000,2248000,216906000,1358000,216016000
4,2,780,-37.8073,144.9952,1330000,2248000,719117440,918000,717787440
2,1,0,-37.8015,144.9972,500000,835500,98359264,335500,97859264
2,2,124,-37.8079,144.9977,1100000,2248000,197950640,1148000,196850640
2,1,147,-37.808,144.994,1315000,2248000,214531984,933000,213216984
3,3,166,-37.8017,145.0001,1447500,2248000,234103424,800500,232655924
2,2,98,-37.8005,144.9952,1135000,2248000,177400464,1113000,176265464
3,1,168,-37.8007,144.9958,1290000,2248000,232494704,958000,231204704
1,1,0,-37.8055,144.9961,470000,835500,96992848,365500,96522848
2,1,162,-37.8016,144.9956,1180000,2248000,226386704,1068000,225206704
3,2,120,-37.8022,144.9954,1195000,2248000,196153584,1053000,194958584
2,1,182,-37.8021,144.9976,1012500,2248000,242193952,1235500,241181452
2,1,172,-37.8086,144.9946,1030000,2248000,234289904,1218000,233259904
3,2,303,-37.718,144.878,840000,2248000,340696128,1408000,339856128
3,2,0,-37.7203,144.8755,730000,835500,101234296,105500,100504296
3,2,0,-37.7203,144.8755,770000,835500,101234296,65500,100464296
2,1,272,-37.7294,144.888,603000,2248000,313244864,1645000,312641864
3,2,239,-37.7218,144.8837,700000,2248000,290120928,1548000,289420928
3,1,290,-37.7273,144.8744,600000,2248000,328827808,1648000,328227808
2,1,168,-37.7215,144.8864,500000,2248000,231051856,1748000,230551856
6,3,976,-37.7239,144.8735,725000,2248000,878257024,1523000,877532024
2,1,110,-37.7216,144.871,450000,2248000,185205072,1798000,184755072
2,1,141,-37.7298,144.8883,515000,2248000,209715936,1733000,209200936
2,1,120,-37.7234,144.8792,530000,2248000,193113296,1718000,192583296
3,1,1063,-37.7249,144.8728,895000,2248000,939727488,1353000,938832488
3,1,0,-37.7217,144.8783,805000,835500,99642904,30500,98837904
3,1,265,-37.7302,144.8855,752000,2248000,309077536,1496000,308325536
3,2,165,-37.727,144.887,700000,2248000,231641440,1548000,230941440
3,1,971,-37.7186,144.876,830000,2248000,867021248,1418000,866191248
2,1,612,-37.7187,144.8765,675000,2248000,581938112,1573000,581263112
3,2,612,-37.7173,144.8796,1042000,2248000,584899264,1206000,583857264
4,3,531,-37.7263,144.8679,773000,2248000,523838432,1475000,523065432
3,3,555,-37.7285,144.8694,810000,2248000,541440640,1438000,540630640
3,2,422,-37.7164,144.8792,715000,2248000,434742208,1533000,434027208
3,2,161,-37.7231,144.8802,540000,2248000,228475616,1708000,227935616
3,2,293,-37.72,144.8776,825000,2248000,332793120,1423000,331968120
3,1,579,-37.7226,144.8733,685000,2248000,557222912,1563000,556537912
4,2,628,-37.7256,144.8739,900000,2248000,598907776,1348000,598007776
2,1,120,-37.8459,144.9555,1275000,2248000,193174640,973000,191899640
3,2,211,-37.8481,144.9499,2850000,2248000,268048160,-602000,265198160
3,2,128,-37.8452,144.9488,1850000,2248000,202452336,398000,200602336
2,1,130,-37.8431,144.9565,1436000,2248000,201077952,812000,199641952
4,2,153,-37.8447,144.9523,2300000,2248000,223578112,-52000,221278112
3,2,132,-37.8415,144.952,1800000,2248000,205615040,448000,203815040
2,1,199,-37.8422,144.9554,2120000,2248000,255607760,128000,253487760
3,2,90,-37.8421,144.9571,1800000,2248000,172425712,448000,170625712
3,2,177,-37.8415,144.9585,2615000,2248000,241182480,-367000,238567480
3,2,0,-37.8451,144.9511,1370000,835500,101295504,-534500,99925504
2,1,149,-37.8443,144.9481,1322500,2248000,216088592,925500,214766092
2,1,141,-37.8424,144.9562,1562500,2248000,209770960,685500,208208460
3,2,211,-37.847,144.9575,2000000,2248000,268052688,248000,266052688
3,2,147,-37.8473,144.9551,3010000,2248000,217472128,-762000,214462128
4,3,327,-37.8467,144.9475,2800000,2248000,362680640,-552000,359880640
3,1,120,-37.8427,144.9546,2100000,2248000,194539952,148000,192439952
3,1,238,-37.8461,144.9528,2000000,2248000,287794496,248000,285794496
1,1,0,-37.8421,144.9517,442500,835500,96969824,393000,96527324
4,2,330,-37.8477,144.9558,4735000,2248000,363463520,-2487000,358728520
4,2,183,-37.8434,144.9495,2140000,2248000,247285184,108000,245145184
2,1,79,-37.8387,144.9519,980000,2248000,160769344,1268000,159789344
3,2,147,-37.8448,144.9453,1740000,2248000,217465792,508000,215725792
1,1,81,-37.8411,144.9497,985000,2248000,160982672,1263000,159997672
4,2,853,-37.7707,145.0318,2000000,2248000,776827520,248000,774827520
4,2,599,-37.7717,145.031,1717500,2248000,576091200,530500,574373700
5,4,809,-37.775,145.0268,2840000,2248000,746604480,-592000,743764480
2,1,88,-37.7791,145.0306,525500,2248000,167923472,1722500,167397972
2,2,155,-37.7804,145.0308,805000,2248000,222467056,1443000,221662056
4,2,606,-37.7743,145.0316,1830000,2248000,581624000,418000,579794000
4,2,575,-37.7723,145.0319,2100000,2248000,557124672,148000,555024672
3,1,180,-37.7802,145.0243,865000,2248000,241993440,1383000,241128440
2,1,0,-37.7773,145.0314,390000,835500,98377480,445500,97987480
2,1,0,-37.7805,145.0262,512000,835500,98374656,323500,97862656
4,2,556,-37.7844,145.0225,1900000,2248000,542104640,348000,540204640
4,2,589,-37.7719,145.0309,1950000,2248000,568188160,298000,566238160
3,2,352,-37.87,144.825,520000,2248000,379405984,1728000,378885984
5,3,729,-37.8721,144.8105,1525000,2248000,681665600,723000,680140600
2,1,292,-37.8687,144.8197,720000,2248000,329025184,1528000,328305184
3,1,506,-37.8693,144.8375,1120000,2248000,499526272,1128000,498406272
4,3,1057,-37.8681,144.819,1780000,2248000,939522240,468000,937742240
3,1,311,-37.8702,144.8143,630000,2248000,345403840,1618000,344773840
3,1,602,-37.8616,144.8116,660000,2248000,575378176,1588000,574718176
2,1,225,-37.8696,144.827,580000,2248000,276079712,1668000,275499712
3,1,777,-37.8697,144.8249,1335000,2248000,713689664,913000,712354664
2,1,127,-37.8686,144.8182,510000,2248000,198624912,1738000,198114912
2,1,115,-37.871,144.8185,425000,2248000,189141776,1823000,188716776
2,1,0,-37.8678,144.8384,391000,835500,98269312,444500,97878312
4,1,745,-37.8658,144.8155,845000,2248000,689759936,1403000,688914936
3,2,69,-37.868,144.8286,730000,2248000,155753392,1518000,155023392
2,1,137,-37.8655,144.8299,447000,2248000,206534720,1801000,206087720
3,1,606,-37.8608,144.8124,678000,2248000,578539776,1570000,577861776
2,2,175,-37.8687,144.8268,580000,2248000,238157824,1668000,237577824
3,2,534,-37.86,144.8245,840000,2248000,523238816,1408000,522398816
3,2,205,-37.8684,144.815,577000,2248000,263225728,1671000,262648728
2,2,675,-37.8653,144.8129,857000,2248000,633298304,1391000,632441304
3,2,70,-37.868,144.8285,730000,2248000,156543632,1518000,155813632
2,1,154,-37.8646,144.8272,535600,2248000,219968048,1712400,219432448
5,3,592,-37.8388,144.8567,1085000,2248000,573419136,1163000,572334136
3,1,533,-37.8291,144.835,781000,2248000,520858144,1467000,520077144
2,1,77,-37.8351,144.8529,421000,2248000,159127392,1827000,158706392
3,1,534,-37.8284,144.8355,683000,2248000,521648672,1565000,520965672
3,2,0,-37.8379,144.8583,720000,835500,101237536,115500,100517536
3,1,328,-37.838,144.8555,588000,2248000,358860608,1660000,358272608
3,1,540,-37.8294,144.8378,710000,2248000,526391968,1538000,525681968
4,1,559,-37.8448,144.8529,875000,2248000,542784960,1373000,541909960
3,2,171,-37.8337,144.8554,675000,2248000,236376352,1573000,235701352
3,1,585,-37.8258,144.8523,708000,2248000,561963968,1540000,561255968
4,2,315,-37.8391,144.8467,693000,2248000,351540864,1555000,350847864
3,2,276,-37.8262,144.8443,620000,2248000,319349984,1628000,318729984
3,1,531,-37.8277,144.8385,728500,2248000,519279520,1519500,518551020
3,2,590,-37.8382,144.8649,931000,2248000,567517888,1317000,566586888
3,2,555,-37.8318,144.8388,815000,2248000,539840640,1433000,539025640
4,1,633,-37.8375,144.8541,1200000,2248000,601266944,1048000,600066944
2,1,153,-37.8332,144.8649,292000,2248000,219197264,1956000,218905264
2,1,0,-37.8543,145.0262,599000,835500,98383320,236500,97784320
3,2,0,-37.8552,145.016,995000,835500,101336640,-159500,100341640
3,2,101,-37.854,145.0135,1205000,2248000,181155104,1043000,179950104
3,2,296,-37.8614,145.0274,1939000,2248000,335272832,309000,333333832
3,1,217,-37.8592,145.0182,1870000,2248000,271240000,378000,269370000
3,2,0,-37.8537,145.0267,1918000,835500,101343040,-1082500,99425040
3,2,205,-37.8574,145.0281,2050000,2248000,263355584,198000,261305584
3,2,2113,-37.8543,145.0262,735000,2248000,1771244288,1513000,1770509288
1,2,144,-37.8564,145.0228,1435000,2248000,212411568,813000,210976568
1,1,0,-37.8619,145.0185,280000,835500,97013264,555500,96733264
2,1,0,-37.8574,145.0174,592500,835500,98378272,243000,97785772
2,1,249,-37.8543,145.016,1210000,2248000,295161472,1038000,293951472
4,2,624,-37.8536,145.0173,2801000,2248000,595849856,-553000,593048856
3,2,405,-37.8545,145.0145,1800000,2248000,421406624,448000,419606624
4,1,495,-37.8613,145.0264,2200000,2248000,492314592,48000,490114592
6,3,1491,-37.8602,145.013,5525000,2248000,1285362688,-3277000,1279837688
1,1,0,-37.8531,145.0115,440000,835500,97007928,395500,96567928
3,1,212,-37.8542,145.0149,1300000,2248000,267285888,948000,265985888
2,1,0,-37.8573,145.0186,704000,835500,98379000,131500,97675000
2,1,0,-37.8596,145.0198,620000,835500,98380008,215500,97760008
3,1,328,-37.8559,145.0158,1900000,2248000,358961344,348000,357061344
2,1,2471,-37.8573,145.0186,710000,2248000,2051207424,1538000,2050497424
2,1,0,-37.8593,145.0156,598000,835500,98377384,237500,97779384
3,1,186,-37.8554,145.0173,1285000,2248000,246739744,963000,245454744
2,1,0,-37.8618,145.0183,520000,835500,98379344,315500,97859344
4,1,709,-37.8574,145.016,3625000,2248000,661431680,-1377000,657806680
4,3,563,-37.8582,145.0138,4200000,2248000,549233280,-1952000,545033280
3,1,103,-37.8542,145.0135,1101000,2248000,181142464,1147000,180041464
3,2,617,-37.8557,145.0264,3512500,2248000,588957440,-1264500,585444940
3,1,0,-37.853,145.0264,869000,835500,99749496,-33500,98880496
1,1,0,-37.8549,145.0113,567000,835500,97008016,268500,96441016
3,1,298,-37.7777,144.9195,940000,2248000,335183872,1308000,334243872
2,1,0,-37.7761,144.9201,467000,835500,98308832,368500,97841832
3,2,277,-37.7777,144.9221,1380000,2248000,320182528,868000,318802528
2,1,423,-37.7736,144.9015,490000,2248000,432593472,1758000,432103472
4,3,478,-37.7729,144.9179,1850000,2248000,481988896,398000,480138896
3,2,285,-37.775,144.9091,971000,2248000,326496544,1277000,325525544
2,1,214,-37.7776,144.9142,710000,2248000,267429328,1538000,266719328
6,3,1014,-37.7721,144.9184,2425000,2248000,908321728,-177000,905896728
2,1,226,-37.7745,144.9093,750000,2248000,276909504,1498000,276159504
2,1,269,-37.7748,144.929,1053000,2248000,310904512,1195000,309851512
3,1,417,-37.7756,144.9208,1377000,2248000,429230016,871000,427853016
3,1,350,-37.7759,144.91,970000,2248000,376273376,1278000,375303376
2,1,118,-37.7807,144.9288,751000,2248000,191569968,1497000,190818968
2,1,173,-37.7731,144.9206,950000,2248000,235030464,1298000,234080464
2,1,228,-37.7718,144.9066,685000,2248000,278488128,1563000,277803128
3,1,594,-37.7819,144.9064,1230000,2248000,569104704,1018000,567874704
2,1,226,-37.7774,144.9186,770000,2248000,276915552,1478000,276145552
4,1,300,-37.7766,144.9143,890000,2248000,338127360,1358000,337237360
3,1,487,-37.7725,144.9146,1440000,2248000,484546752,808000,483106752
3,2,440,-37.7746,144.9031,1000000,2248000,448989184,1248000,447989184
3,2,532,-37.7737,144.904,1435000,2248000,521697088,813000,520262088
1,1,0,-37.7723,144.9094,390000,835500,96935576,445500,96545576
3,2,495,-37.7821,144.9055,1425000,2248000,492457888,823000,491032888
4,2,683,-37.775,144.932,1340000,2248000,642415808,908000,641075808
3,1,263,-37.7753,144.9116,955000,2248000,307518272,1293000,306563272
4,2,559,-37.7791,144.9136,1100000,2248000,544407872,1148000,543307872
2,1,0,-37.773,144.9303,432000,835500,98314736,403500,97882736
4,3,562,-37.782,144.903,1640000,2248000,548365824,608000,546725824
6,2,461,-37.78,144.9295,1430000,2248000,469700896,818000,468270896
2,1,301,-37.7791,144.914,610000,2248000,336185344,1638000,335575344
3,3,491,-37.7727,144.9136,940000,2248000,490893952,1308000,489953952
3,1,242,-37.7765,144.9114,890000,2248000,290922016,1358000,290032016
3,2,617,-37.7742,144.906,1180000,2248000,588873792,1068000,587693792
4,2,597,-37.7757,144.9088,1480000,2248000,574435904,768000,572955904
2,2,146,-37.7713,144.9038,865000,2248000,215275120,1383000,214410120
2,1,0,-37.7733,144.9219,442000,835500,98309616,393500,97867616
3,1,506,-37.7779,144.9133,1037500,2248000,499562240,1210500,498524740
3,2,318,-37.7744,144.9035,1050000,2248000,352572896,1198000,351522896
2,1,0,-37.7749,144.9137,440000,835500,98304744,395500,97864744
4,2,418,-37.7766,144.9187,1430000,2248000,432978592,818000,431548592
3,2,272,-37.7774,144.928,1130000,2248000,316234560,1118000,315104560
3,1,296,-37.777,144.9176,1135000,2248000,333602048,1113000,332467048
4,2,298,-37.7778,144.9131,950000,2248000,338139456,1298000,337189456
2,1,1957,-37.7731,144.9074,390000,2248000,1644915328,1858000,1644525328
4,1,552,-37.7769,144.9138,1345000,2248000,537282304,903000,535937304
3,2,416,-37.7727,144.9055,1381500,2248000,430023232,866500,428641732
3,2,285,-37.7778,144.9061,940000,2248000,326495040,1308000,325555040
3,2,314,-37.7778,144.9042,995000,2248000,349412544,1253000,348417544
3,2,576,-37.7816,144.9217,786000,2248000,556482048,1462000,555696048
2,1,252,-37.7825,144.9206,705000,2248000,297465184,1543000,296760184
2,1,124,-37.7807,144.9285,760000,2248000,196311584,1488000,195551584
3,2,200,-37.7766,144.9277,1000000,2248000,259332800,1248000,258332800
3,1,278,-37.7768,144.9223,1305000,2248000,319379520,943000,318074520
3,1,452,-37.7762,144.9174,1215000,2248000,456888416,1033000,455673416
2,1,194,-37.7772,144.9118,545000,2248000,251621792,1703000,251076792
4,2,598,-37.7774,144.9104,1705000,2248000,575227392,543000,573522392
4,3,753,-37.8669,145.0767,2650000,2248000,699429888,-402000,696779888
3,2,599,-37.8673,145.0688,1670000,2248000,574759488,578000,573089488
3,3,310,-37.874,145.0714,2050000,2248000,347958816,198000,345908816
3,2,731,-37.8666,145.0676,1555000,2248000,679078080,693000,677523080
3,3,276,-37.8699,145.0778,1100000,2248000,321092128,1148000,319992128
3,1,583,-37.8685,145.0786,1337000,2248000,560527616,911000,559190616
8,7,1472,-37.8729,145.0788,2950000,2248000,1279494528,-702000,1276544528
3,2,516,-37.8675,145.0668,1518000,2248000,509163488,730000,507645488
3,1,806,-37.8695,145.084,1710000,2248000,736767680,538000,735057680
3,1,780,-37.8599,145.0815,1655000,2248000,716217344,593000,714562344
4,2,780,-37.86,145.0817,1550000,2248000,719176896,698000,717626896
3,2,351,-37.8742,145.07,1662000,2248000,378767008,586000,377105008
3,2,702,-37.8737,145.0695,1665000,2248000,656161536,583000,654496536
5,5,755,-37.8598,145.0796,3510000,2248000,705564160,-1262000,702054160
3,2,153,-37.8655,145.0808,900000,2248000,222293424,1348000,221393424
5,4,1075,-37.8714,145.073,2752000,2248000,956863808,-504000,954111808
3,2,710,-37.8653,145.0897,1500000,2248000,662495296,748000,660995296
4,2,749,-37.8669,145.077,1800000,2248000,694675520,448000,692875520
3,2,724,-37.8619,145.0879,1830000,2248000,673558016,418000,671728016
3,1,605,-37.8703,145.0774,1415000,2248000,577913728,833000,576498728
2,1,687,-37.872,145.0692,1440000,2248000,641347136,808000,639907136
4,2,321,-37.8693,145.08,1250000,2248000,356429792,998000,355179792
5,3,700,-37.8724,145.0758,1600000,2248000,658910336,648000,657310336
4,2,696,-37.8711,145.0746,1860000,2248000,652788736,388000,650928736
4,2,514,-37.8664,145.0772,1790000,2248000,508955360,458000,507165360
4,2,844,-37.8715,145.0688,1950000,2248000,769749376,298000,767799376
3,1,697,-37.8636,145.0903,1650000,2248000,650628352,598000,648978352
4,3,372,-37.8716,145.0999,1200000,2248000,398340800,1048000,397140800
2,1,695,-37.8694,145.0944,1075000,2248000,647684672,1173000,646609672
4,2,621,-37.8647,145.1023,1500000,2248000,593532608,748000,592032608
2,1,367,-37.8662,145.109,700000,2248000,388475328,1548000,387775328
3,2,400,-37.8675,145.106,761000,2248000,417512992,1487000,416751992
3,1,792,-37.864,145.0972,1365000,2248000,725711040,883000,724346040
4,2,803,-37.8621,145.1126,1100000,2248000,737373056,1148000,736273056
2,1,216,-37.8711,145.1017,690000,2248000,269136288,1558000,268446288
3,2,782,-37.8621,145.1021,1631000,2248000,719404032,617000,717773032
4,2,593,-37.8655,145.096,1500000,2248000,571400448,748000,569900448
5,3,585,-37.8637,145.1024,1529500,2248000,568041280,718500,566511780
2,1,153,-37.8696,145.0962,600000,2248000,219343904,1648000,218743904
4,2,766,-37.8629,145.1097,1240000,2248000,708130240,1008000,706890240
2,1,192,-37.8709,145.102,700000,2248000,250169312,1548000,249469312
2,1,586,-37.8683,145.1082,1110000,2248000,561550528,1138000,560440528
3,1,760,-37.858,145.1038,1305000,2248000,700424832,943000,699119832
3,2,320,-37.87,145.1103,855000,2248000,354292032,1393000,353437032
3,2,256,-37.8655,145.1096,900500,2248000,303711936,1347500,302811436
3,2,839,-37.8614,145.1098,1200000,2248000,764455808,1048000,763255808
3,1,212,-37.8723,145.1089,830000,2248000,267345872,1418000,266515872
3,1,593,-37.7677,144.8674,850000,2248000,568288768,1398000,567438768
3,1,0,-37.7634,144.8611,750000,835500,99637224,85500,98887224
3,3,557,-37.77,144.8572,851000,2248000,543018560,1397000,542167560
4,2,569,-37.7654,144.8655,1155000,2248000,552279616,1093000,551124616
3,1,570,-37.7591,144.8542,680000,2248000,550102784,1568000,549422784
3,1,550,-37.7632,144.8622,627500,2248000,534302176,1620500,533674676
4,3,761,-37.7524,144.8714,950000,2248000,705612416,1298000,704662416
3,1,581,-37.7691,144.8575,705000,2248000,558799232,1543000,558094232
4,3,873,-37.7609,144.8639,1100000,2248000,794122304,1148000,793022304
3,1,586,-37.7642,144.8603,892500,2248000,562751872,1355500,561859372
2,1,220,-37.756,144.8641,522500,2248000,272137728,1725500,271615228
4,2,554,-37.7649,144.8633,680000,2248000,540423744,1568000,539743744
3,1,812,-37.765,144.8578,875000,2248000,741357952,1373000,740482952
4,2,589,-37.7573,144.8534,762000,2248000,568077248,1486000,567315248
2,1,0,-37.7608,144.863,411000,835500,98271888,424500,97860888
3,2,593,-37.7607,144.8581,805000,2248000,569875456,1443000,569070456
3,2,582,-37.7584,144.8568,634000,2248000,561181120,1614000,560547120
4,2,244,-37.8668,144.9928,1819000,2248000,295522816,429000,293703816
2,1,0,-37.8731,144.9958,410000,835500,98366832,425500,97956832
2,1,114,-37.8723,144.9961,1015000,2248000,188460960,1233000,187445960
2,1,0,-37.8725,144.9952,502500,835500,98366384,333000,97863884
2,1,0,-37.8742,144.9972,520000,835500,98367808,315500,97847808
2,1,0,-37.8726,144.9962,442000,835500,98367000,393500,97925000
3,1,178,-37.8663,144.9948,1193000,2248000,240404784,1055000,239211784
2,1,0,-37.8678,144.9966,416000,835500,98366688,419500,97950688
2,1,0,-37.8667,144.9917,474000,835500,98363536,361500,97889536
2,1,159,-37.874,144.9933,981000,2248000,224022880,1267000,223041880
3,2,339,-37.872,144.9909,1690000,2248000,369234496,558000,367544496
2,1,483,-37.8727,144.9969,540000,2248000,480081760,1708000,479541760
2,1,659,-37.8094,145.0807,2100000,2248000,619218496,148000,617118496
4,2,715,-37.811,145.0958,1800000,2248000,667810432,448000,666010432
2,1,208,-37.8128,145.0975,1255000,2248000,262804496,993000,261549496
3,2,206,-37.8161,145.0812,1070000,2248000,264173744,1178000,263103744
5,3,715,-37.8028,145.0768,2570000,2248000,670757184,-322000,668187184
4,2,744,-37.8147,145.0748,2400000,2248000,690716544,-152000,688316544
2,1,122,-37.8124,145.0916,806000,2248000,194835088,1442000,194029088
6,4,2051,-37.8051,145.1016,4000000,2248000,1729571584,-1752000,1725571584
5,3,600,-37.8061,145.0801,2250000,2248000,579875328,-2000,577625328
5,3,678,-37.8048,145.0708,2800000,2248000,641512640,-552000,638712640
2,1,1015,-37.8074,145.0826,1850000,2248000,900565696,398000,898715696
3,1,188,-37.8065,145.065,700000,2248000,248343968,1548000,247643968
2,1,0,-37.8162,145.0841,500000,835500,98414488,335500,97914488
3,2,699,-37.814,145.0966,2125000,2248000,653800320,123000,651675320
4,2,577,-37.8032,145.0693,1800000,2248000,558731968,448000,556931968
2,1,0,-37.8116,145.0724,635000,835500,98406744,200500,97771744
2,1,0,-37.8144,145.0993,526000,835500,98423632,309500,97897632
3,1,281,-37.8013,145.0652,905000,2248000,321841216,1343000,320936216
4,3,453,-37.8044,145.1006,1750000,2248000,462347552,498000,460597552
2,1,121,-37.8112,145.0881,760000,2248000,194042496,1488000,193282496
3,2,219,-37.8125,145.0849,1367000,2248000,274449440,881000,273082440
4,3,241,-37.8042,145.1042,1400000,2248000,294806400,848000,293406400
4,2,935,-37.8157,145.0795,3270000,2248000,841666688,-1022000,838396688
2,1,115,-37.8122,145.0879,625000,2248000,189300704,1623000,188675704
4,3,674,-37.8068,145.0786,2730000,2248000,636990272,-482000,634260272
2,1,0,-37.8152,145.0839,460000,835500,98414240,375500,97954240
2,1,231,-37.8123,145.0821,1053000,2248000,280971808,1195000,279918808
3,2,306,-37.8106,145.0848,1472000,2248000,343205120,776000,341733120
2,1,87,-37.8134,145.081,754000,2248000,167168224,1494000,166414224
4,2,752,-37.8149,145.0747,2188000,2248000,697038912,60000,694850912
2,1,213,-37.8092,145.0789,755000,2248000,266744080,1493000,265989080
4,3,1007,-37.8135,145.0995,3290000,2248000,900173504,-1042000,896883504
4,2,685,-37.8056,145.071,2410000,2248000,644085568,-162000,641675568
2,1,0,-37.8147,145.084,650000,835500,98414248,185500,97764248
4,1,739,-37.8039,145.0631,2000000,2248000,685163328,248000,683163328
4,2,665,-37.8057,145.0825,1900000,2248000,628286656,348000,626386656
3,2,706,-37.8161,145.0748,3401000,2248000,659319168,-1153000,655918168
3,2,613,-37.8056,145.0688,1750000,2248000,585816448,498000,584066448
5,3,715,-37.8028,145.0768,3020000,2248000,670757184,-772000,667737184
5,2,981,-37.8058,145.0627,2450000,2248000,879375168,-202000,876925168
2,1,130,-37.812,145.0876,730000,2248000,201154976,1518000,200424976
3,2,404,-37.8075,145.1011,1500000,2248000,420664096,748000,419164096
4,1,672,-37.8099,145.0792,1700000,2248000,632223872,548000,630523872
3,2,260,-37.7966,145.1021,1315000,2248000,306860416,933000,305545416
3,2,778,-37.7939,145.0789,1500000,2248000,716220544,748000,714720544
4,4,1135,-37.8014,145.0892,3230000,2248000,1002917312,-982000,999687312
4,2,647,-37.7917,145.0868,1905000,2248000,614062208,343000,612157208
5,4,760,-37.7907,145.0907,3300000,2248000,707921024,-1052000,704621024
4,2,642,-37.7988,145.0726,1900000,2248000,610102912,348000,608202912
3,1,888,-37.8002,145.0949,2251000,2248000,801570688,-3000,799319688
4,2,750,-37.7906,145.0788,2205000,2248000,695457984,43000,693252984
3,2,347,-37.7947,145.1035,1265000,2248000,375617056,983000,374352056
4,2,673,-37.7856,145.0918,1750000,2248000,634612416,498000,632862416
3,1,665,-37.7862,145.0781,1450000,2248000,625322176,798000,623872176
4,2,772,-37.7959,145.0787,2614000,2248000,712845120,-366000,710231120
4,2,736,-37.7944,145.1028,1825000,2248000,684409024,423000,682584024
5,4,886,-37.804,145.0951,3250000,2248000,807502912,-1002000,804252912
3,2,207,-37.7893,145.092,1150000,2248000,264967488,1098000,263817488
4,2,662,-37.798,145.1007,1572000,2248000,625926080,676000,624354080
5,3,705,-37.7851,145.0775,1750000,2248000,662852544,498000,661102544
4,2,619,-37.8025,145.0843,1850000,2248000,591933632,398000,590083632
4,3,1274,-37.7822,145.0907,2130000,2248000,1111174272,118000,1109044272
5,4,624,-37.802,145.0797,3690000,2248000,600434944,-1442000,596744944
4,2,610,-37.7843,145.0891,1740000,2248000,584821760,508000,583081760
4,3,657,-37.7981,145.0904,2575000,2248000,623561472,-327000,620986472
4,2,517,-37.783,145.0926,1388800,2248000,511325920,859200,509937120
4,2,587,-37.7841,145.0953,1800000,2248000,566648704,448000,564848704
4,3,1070,-37.7975,145.0716,2910000,2248000,949943232,-662000,947033232
5,3,900,-37.7868,145.0677,2200000,2248000,816955008,48000,814755008
3,2,763,-37.7935,145.0865,1700000,2248000,704370752,548000,702670752
3,3,310,-37.7949,145.1014,1230000,2248000,347968000,1018000,346738000
7,3,637,-37.7898,145.0967,2600000,2248000,611857024,-352000,609257024
4,3,665,-37.7889,145.0904,1950000,2248000,629882816,298000,627932816
5,2,710,-37.7907,145.0916,1750000,2248000,665220096,498000,663470096
5,2,1002,-37.796,145.0984,2000000,2248000,895992256,248000,893992256
3,1,605,-37.7951,145.0696,1480000,2248000,577900032,768000,576420032
3,1,722,-37.7956,145.0829,1818000,2248000,670373248,430000,668555248
4,2,1235,-37.7988,145.089,2525000,2248000,1078760192,-277000,1076235192
4,3,904,-37.797,145.086,3360000,2248000,818762496,-1112000,815402496
3,1,713,-37.7982,145.0816,1903000,2248000,663260096,345000,661357096
4,3,869,-37.8002,145.0999,1720000,2248000,791110912,528000,789390912
4,2,667,-37.7835,145.0883,1675000,2248000,629868224,573000,628193224
4,3,362,-37.7987,145.0788,1680000,2248000,390416256,568000,388736256
5,5,1364,-37.7961,145.0859,4000000,2248000,1186852608,-1752000,1182852608
4,2,1010,-37.7982,145.0903,2205000,2248000,900943616,43000,898738616
3,2,949,-37.796,145.0696,2100000,2248000,851356224,148000,849256224
2,1,177,-37.7935,145.0679,685000,2248000,238284704,1563000,237599704
3,2,368,-37.7846,145.0935,1335000,2248000,392205952,913000,390870952
4,2,587,-37.7841,145.0953,1900000,2248000,566648704,348000,564748704
2,1,250,-37.7996,145.0959,1040000,2248000,295994464,1208000,294954464
4,2,644,-37.7997,145.0993,1250000,2248000,611700032,998000,610450032
5,3,842,-37.7854,145.0869,1875000,2248000,771129280,373000,769254280
4,2,701,-37.7839,145.0954,1530000,2248000,656742720,718000,655212720
4,2,754,-37.786,145.0886,1700000,2248000,698624640,548000,696924640
3,1,657,-37.7895,145.0985,1651000,2248000,619012736,597000,617361736
5,3,900,-37.7868,145.0677,1920000,2248000,816955008,328000,815035008
5,2,845,-37.7898,145.1021,1560000,2248000,771916864,688000,770356864
3,2,207,-37.7893,145.092,1038000,2248000,264967520,1210000,263929520
5,3,737,-37.7975,145.0961,1660000,2248000,688155008,588000,686495008
3,2,720,-37.7938,145.0838,1770000,2248000,670386176,478000,668616176
2,1,0,-37.7938,145.0666,691500,835500,98401080,144000,97709580
3,1,348,-37.9273,145.0479,875000,2248000,374795456,1373000,373920456
3,2,613,-37.9311,145.0428,1425000,2248000,585815232,823000,584390232
2,1,140,-37.9204,145.0443,851000,2248000,209044064,1397000,208193064
3,2,299,-37.9272,145.0406,1222500,2248000,337659552,1025500,336437052
3,1,576,-37.9149,145.0254,1317500,2248000,554968256,930500,553650756
2,1,0,-37.9332,145.045,360000,835500,98404160,475500,98044160
4,3,291,-37.9278,145.0337,1435000,2248000,334292480,813000,332857480
3,1,692,-37.9263,145.04,1110000,2248000,646653248,1138000,645543248
4,2,795,-37.9166,145.0314,2435000,2248000,731007040,-187000,728572040
3,2,565,-37.9134,145.0263,1500000,2248000,547868608,748000,546368608
4,2,697,-37.9318,145.0474,1300000,2248000,653569408,948000,652269408
3,1,584,-37.9199,145.0477,1125000,2248000,561304960,1123000,560179960
4,2,610,-37.9291,145.0472,1328000,2248000,584812992,920000,583484992
3,2,526,-37.9279,145.031,1340000,2248000,517051552,908000,515711552
4,3,271,-37.9252,145.0494,1155000,2248000,318495840,1093000,317340840
3,1,758,-37.9267,145.043,1275000,2248000,698814912,973000,697539912
2,1,296,-37.9243,145.0376,855000,2248000,332327008,1393000,331472008
2,1,116,-37.9245,145.0336,650000,2248000,190070784,1598000,189420784
4,2,902,-37.924,145.0504,1815000,2248000,815581696,433000,813766696
4,3,557,-37.9132,145.0251,2255000,2248000,544504960,-7000,542249960
2,2,226,-37.9274,145.031,855000,2248000,278595648,1393000,277740648
4,2,855,-37.9163,145.0324,1860000,2248000,778425536,388000,776565536
2,1,227,-37.9326,145.0387,725000,2248000,277798016,1523000,277073016
3,1,632,-37.9282,145.0367,1293000,2248000,599233472,955000,597940472
3,2,690,-37.9317,145.0469,1328000,2248000,646670784,920000,645342784
4,2,354,-37.9326,145.0441,1247000,2248000,382494976,1001000,381247976
3,1,624,-37.9256,145.0374,1370000,2248000,592911296,878000,591541296
3,2,581,-37.9286,145.0495,1095000,2248000,560529408,1153000,559434408
2,1,677,-37.9173,145.0359,725000,2248000,633428992,1523000,632703992
3,2,147,-37.9317,145.0352,825000,2248000,217531360,1423000,216706360
3,2,0,-37.9289,145.0478,1235000,835500,101364864,-399500,100129864
3,1,694,-37.9315,145.0445,1165000,2248000,648237184,1083000,647072184
4,2,736,-37.9224,145.0462,1910000,2248000,684389248,338000,682479248
2,1,336,-37.929,145.0375,820000,2248000,363939456,1428000,363119456
4,2,611,-37.9289,145.0481,1430000,2248000,585603840,818000,584173840
2,1,274,-37.9178,145.0413,910000,2248000,314941920,1338000,314031920
4,4,579,-37.9155,145.0243,2520000,2248000,563484544,-272000,560964544
5,2,567,-37.9144,145.0401,1900000,2248000,552190208,348000,550290208
2,2,123,-37.9307,145.0379,670000,2248000,197199520,1578000,196529520
2,1,83,-37.9259,145.0341,680000,2248000,163991392,1568000,163311392
4,3,346,-37.9294,145.041,1320000,2248000,377763584,928000,376443584
6,3,708,-37.9181,145.044,1900000,2248000,666584704,348000,664684704
3,2,572,-37.9148,145.0404,1535000,2248000,553409536,713000,551874536
4,1,594,-37.9206,145.0383,1281000,2248000,570568448,967000,569287448
5,2,664,-37.9241,145.048,1385000,2248000,628855232,863000,627470232
4,4,579,-37.9155,145.0243,2620000,2248000,563484544,-372000,560864544
2,2,176,-37.9237,145.0763,825000,2248000,239108160,1423000,238283160
2,1,281,-37.9255,145.0796,746000,2248000,320498528,1502000,319752528
5,2,683,-37.9333,145.0602,1275000,2248000,643879488,973000,642604488
3,2,384,-37.9229,145.0557,1025000,2248000,404843712,1223000,403818712
2,1,76,-37.91,145.0842,495000,2248000,158488256,1753000,157993256
4,2,585,-37.9167,145.0771,1220000,2248000,565072448,1028000,563852448
3,1,565,-37.9262,145.0808,885000,2248000,546310336,1363000,545425336
3,2,292,-37.9168,145.069,830000,2248000,332143712,1418000,331313712
4,3,291,-37.9347,145.0546,1210000,2248000,334306144,1038000,333096144
4,2,321,-37.914,145.0714,1160000,2248000,356429728,1088000,355269728
3,2,730,-37.9119,145.0705,1215000,2248000,678294976,1033000,677079976
4,2,619,-37.9358,145.0688,1200000,2248000,591939712,1048000,590739712
3,2,627,-37.9284,145.0668,1050000,2248000,596893888,1198000,595843888
5,2,618,-37.9209,145.0757,950000,2248000,592518144,1298000,591568144
2,2,0,-37.9212,145.0674,380000,835500,100009816,455500,99629816
3,2,610,-37.9231,145.066,1338000,2248000,583457664,910000,582119664
2,1,265,-37.9223,145.0747,651000,2248000,307850304,1597000,307199304
3,2,590,-37.9256,145.0757,1390000,2248000,567657920,858000,566267920
3,1,578,-37.9186,145.0709,1100000,2248000,556577280,1148000,555477280
4,1,636,-37.925,145.0612,1206000,2248000,603775616,1042000,602569616
2,1,0,-37.9082,145.0681,486500,835500,98415448,349000,97928948
4,2,604,-37.9153,145.0707,1415000,2248000,580084096,833000,578669096
4,2,305,-37.9245,145.0507,1185000,2248000,343773472,1063000,342588472
4,3,313,-37.9164,145.0765,1060000,2248000,351704064,1188000,350644064
3,2,295,-37.9239,145.0781,845000,2248000,334521056,1403000,333676056
3,2,254,-37.9227,145.0558,860000,2248000,302104960,1388000,301244960
3,2,167,-37.9219,145.0733,921000,2248000,233359632,1327000,232438632
2,1,300,-37.9099,145.0726,742500,2248000,335508064,1505500,334765564
3,2,578,-37.9303,145.0805,920000,2248000,558177792,1328000,557257792
2,1,591,-37.9179,145.071,702000,2248000,565484992,1546000,564782992
3,2,268,-37.9196,145.0691,805000,2248000,313176928,1443000,312371928
4,2,274,-37.9257,145.0735,1100000,2248000,319288352,1148000,318188352
3,1,726,-37.9117,145.0695,1050000,2248000,673539840,1198000,672489840
2,2,201,-37.9293,145.0657,722000,2248000,258859776,1526000,258137776
3,1,588,-37.9286,145.069,930000,2248000,564480256,1318000,563550256
3,2,291,-37.919,145.0829,921000,2248000,331362240,1327000,330441240
4,1,610,-37.9193,145.0691,1035000,2248000,583232000,1213000,582197000
4,2,618,-37.9252,145.0562,1352000,2248000,591140480,896000,589788480
4,2,296,-37.9197,145.057,1005000,2248000,336664096,1243000,335659096
5,2,659,-37.906,145.0547,1600000,2248000,624905792,648000,623305792
3,1,721,-37.9244,145.0665,1200000,2248000,669588032,1048000,668388032
3,2,421,-37.9168,145.0809,780000,2248000,434099616,1468000,433319616
4,2,314,-37.9299,145.0598,1250000,2248000,350892384,998000,349642384
4,2,583,-37.9262,145.0624,1110000,2248000,563483968,1138000,562373968
4,2,700,-37.9117,145.0534,1690000,2248000,655941632,558000,654251632
3,3,391,-37.9149,145.0788,791000,2248000,411982400,1457000,411191400
3,1,780,-37.9347,145.0507,900000,2248000,716207168,1348000,715307168
3,2,267,-37.9176,145.0566,970000,2248000,312378720,1278000,311408720
3,2,213,-37.9079,145.0707,823000,2248000,269710144,1425000,268887144
4,2,316,-37.9198,145.0789,1045000,2248000,352483552,1203000,351438552
2,1,154,-37.9079,145.0685,655000,2248000,220121664,1593000,219466664
5,3,623,-37.9066,145.0541,1550000,2248000,598047936,698000,596497936
3,1,250,-37.9087,145.0537,835000,2248000,297347552,1413000,296512552
4,2,319,-37.9256,145.0533,1465000,2248000,354839424,783000,353374424
3,1,587,-37.9241,145.0763,910000,2248000,563693952,1338000,562783952
3,2,388,-37.9329,145.053,920000,2248000,408004448,1328000,407084448
3,2,230,-37.9179,145.0592,935000,2248000,283139296,1313000,282204296
3,1,543,-37.9242,145.0705,977000,2248000,528917280,1271000,527940280
3,1,686,-37.9113,145.0765,1352000,2248000,641932160,896000,640580160
4,2,575,-37.9274,145.0654,1115000,2248000,557163520,1133000,556048520
3,1,692,-37.9232,145.0563,1197000,2248000,646662912,1051000,645465912
2,2,0,-37.9292,145.0708,485000,835500,100012848,350500,99527848
4,1,582,-37.9129,145.0598,1365000,2248000,561097216,883000,559732216
4,2,598,-37.9138,145.0774,1698888,2248000,575346176,549112,573647288
3,2,283,-37.9142,145.08,965000,2248000,325037504,1283000,324072504
3,2,365,-37.9225,145.0754,870000,2248000,389840160,1378000,388970160
3,2,629,-37.912,145.0752,1161000,2248000,598477696,1087000,597316696
3,1,676,-37.9307,145.0531,1266000,2248000,634017024,982000,632751024
3,2,194,-37.9272,145.0801,700000,2248000,254702496,1548000,254002496
4,4,363,-37.9116,145.0686,1325000,2248000,392806816,923000,391481816
3,2,281,-37.9257,145.0811,770000,2248000,323458944,1478000,322688944
1,1,0,-37.9315,145.0619,380000,835500,97048160,455500,96668160
4,2,620,-37.9281,145.0669,1175000,2248000,592728000,1073000,591553000
3,1,640,-37.916,145.0776,1200000,2248000,605579648,1048000,604379648
4,1,684,-37.9147,145.0751,1370000,2248000,641717312,878000,640347312
4,1,725,-37.9289,145.0502,1433500,2248000,674105856,814500,672672356
3,2,210,-37.9075,145.061,860000,2248000,267333200,1388000,266473200
2,1,194,-37.9107,145.0598,715000,2248000,251728592,1533000,251013592
2,1,0,-37.9212,145.0606,710000,835500,98412352,125500,97702352
5,3,583,-37.9143,145.0699,1550000,2248000,566446656,698000,564896656
3,1,406,-37.9286,145.0737,790000,2248000,420648832,1458000,419858832
3,1,596,-37.9251,145.0771,1020000,2248000,570807232,1228000,569787232
3,2,185,-37.9159,145.0787,886000,2248000,247587632,1362000,246701632
4,2,625,-37.9374,145.0726,1015000,2248000,596684096,1233000,595669096
4,2,610,-37.9207,145.0757,1255000,2248000,584829504,993000,583574504
3,1,593,-37.9178,145.067,1320000,2248000,568429376,928000,567109376
3,2,326,-37.9236,145.0545,870000,2248000,359005792,1378000,358135792
4,2,592,-37.9351,145.0572,1472500,2248000,570594496,775500,569121996
2,2,298,-37.908,145.0716,640000,2248000,335519872,1608000,334879872
4,2,697,-37.8151,145.135,1620000,2248000,653609600,628000,651989600
2,1,140,-37.8271,145.1299,645000,2248000,209085776,1603000,208440776
4,2,729,-37.8233,145.1267,1560000,2248000,678894976,688000,677334976
3,2,458,-37.8257,145.1216,1715000,2248000,463355008,533000,461640008
3,1,550,-37.8275,145.1298,1200000,2248000,534474432,1048000,533274432
3,1,741,-37.8258,145.1246,1760000,2248000,685418176,488000,683658176
3,1,384,-37.8167,145.1373,948000,2248000,403288192,1300000,402340192
2,2,0,-37.8216,145.127,465000,835500,100034800,370500,99569800
4,2,299,-37.8282,145.1301,975000,2248000,339069216,1273000,338094216
3,1,702,-37.827,145.1209,1325000,2248000,654594368,923000,653269368
3,2,150,-37.8287,145.1319,750000,2248000,219949648,1498000,219199648
3,2,643,-37.8285,145.1272,1400000,2248000,609564032,848000,608164032
3,1,664,-37.8235,145.1276,1500000,2248000,624566720,748000,623066720
4,2,692,-37.8247,145.1281,1600000,2248000,649654976,648000,648054976
4,2,780,-37.8244,145.1319,1461400,2248000,719203584,786600,717742184
3,1,211,-37.8275,145.1232,775000,2248000,266559104,1473000,265784104
4,4,707,-37.8166,145.1354,1670000,2248000,664699520,578000,663029520
3,1,763,-37.8166,145.1215,4000000,2248000,702801664,-1752000,698801664
3,1,307,-37.8247,145.1206,928000,2248000,342425888,1320000,341497888
2,1,151,-37.8234,145.1235,636000,2248000,217774688,1612000,217138688
3,1,755,-37.8264,145.1248,1170000,2248000,696482496,1078000,695312496
4,2,590,-37.8274,145.1242,1670000,2248000,569042496,578000,567372496
3,1,492,-37.8283,145.1195,857000,2248000,488630944,1391000,487773944
3,2,238,-37.8154,145.1355,822500,2248000,289496608,1425500,288674108
2,1,566,-37.7839,144.8524,645000,2248000,545577152,1603000,544932152
3,1,220,-37.785,144.8561,502000,2248000,273502400,1746000,273000400
3,2,327,-37.7851,144.8517,495000,2248000,359654944,1753000,359159944
2,1,749,-37.7814,144.847,868000,2248000,690198272,1380000,689330272
4,2,283,-37.7908,144.8485,645000,2248000,326246720,1603000,325601720
3,2,216,-37.7865,144.8605,652000,2248000,271937408,1596000,271285408
4,2,606,-37.788,144.862,850000,2248000,581521216,1398000,580671216
3,1,559,-37.7923,144.852,575000,2248000,541412032,1673000,540837032
4,2,393,-37.7763,144.8543,882000,2248000,413181408,1366000,412299408
3,2,544,-37.7815,144.855,730000,2248000,531151424,1518000,530421424
4,2,283,-37.7908,144.8485,610000,2248000,326246720,1638000,325636720
3,1,557,-37.7899,144.8515,696000,2248000,539830912,1552000,539134912
3,2,198,-37.7827,144.8625,579000,2248000,257712800,1669000,257133800
3,1,658,-37.7905,144.8485,765000,2248000,619649280,1483000,618884280
2,1,115,-37.7948,144.854,475000,2248000,189154704,1773000,188679704
4,2,288,-37.7775,144.855,550000,2248000,330200672,1698000,329650672
3,1,158,-37.7889,144.8465,495000,2248000,224498432,1753000,224003432
3,2,566,-37.7844,144.8523,565000,2248000,548536704,1683000,547971704
3,1,366,-37.9038,145.0001,1635000,2248000,388988608,613000,387353608
4,3,836,-37.9071,144.9898,3695000,2248000,764975872,-1447000,761280872
2,1,0,-37.9081,145.0043,536000,835500,98376176,299500,97840176
4,3,742,-37.914,144.9878,3700000,2248000,690687360,-1452000,686987360
3,1,432,-37.9172,144.996,1975000,2248000,441147424,273000,439172424
3,1,340,-37.9205,145.0007,1390000,2248000,368443232,858000,367053232
4,3,487,-37.8926,144.9991,2905000,2248000,489165664,-657000,486260664
2,2,329,-37.9172,145.004,1300000,2248000,359978624,948000,358678624
3,2,411,-37.918,145.0035,1725000,2248000,426149088,523000,424424088
3,2,463,-37.9082,144.9968,2100000,2248000,467239392,148000,465139392
2,1,90,-37.9122,145.0038,800000,2248000,169503232,1448000,168703232
4,2,615,-37.8956,145.0026,1761000,2248000,588733056,487000,586972056
3,2,0,-37.9166,144.9942,1302500,835500,101330432,-467000,100027932
5,3,509,-37.9118,144.9984,2750000,2248000,507920192,-502000,505170192
2,1,232,-37.9157,144.9973,892500,2248000,281722080,1355500,280829580
4,2,550,-37.8954,145.0017,2145000,2248000,537363136,103000,535218136
5,2,710,-37.9241,145.0008,3171000,2248000,665179968,-923000,662008968
2,2,0,-37.9042,144.9954,620000,835500,99963504,215500,99343504
3,2,345,-37.8943,144.9907,1475000,2248000,373978720,773000,372503720
3,2,0,-37.9174,144.9895,1650000,835500,101327632,-814500,99677632
5,2,655,-37.9264,145.0044,1562500,2248000,621716032,685500,620153532
3,3,398,-37.899,144.9901,2050000,2248000,417458016,198000,415408016
4,3,644,-37.8964,144.9972,3320000,2248000,613241728,-1072000,609921728
2,1,0,-37.9131,144.995,1100000,835500,98371024,-264500,97271024
3,2,354,-37.8916,145.0017,1650000,2248000,381097824,598000,379447824
2,1,352,-37.9154,145.001,1570000,2248000,376560192,678000,374990192
3,2,404,-37.9228,144.9996,1785000,2248000,420615168,463000,418830168
3,2,275,-37.9153,144.9924,1875000,2248000,318661344,373000,316786344
3,1,277,-37.9268,144.991,1266000,2248000,318649120,982000,317383120
5,3,895,-37.9204,145.0028,2730000,2248000,812979264,-482000,810249264
4,3,565,-37.8975,144.9991,3295888,2248000,550809408,-1047888,547513520
1,1,0,-37.9181,144.993,375000,835500,97004168,460500,96629168
2,1,0,-37.9112,144.9909,756000,835500,98368288,79500,97612288
5,5,552,-37.9012,144.997,2100000,2248000,545087488,148000,542987488
3,2,547,-37.9271,145.0034,2375000,2248000,533630720,-127000,531255720
3,1,426,-37.9254,145.0045,1385000,2248000,436411840,863000,435026840
2,1,107,-37.8958,144.9982,858000,2248000,182932912,1390000,182074912
4,2,569,-37.8962,145.0011,2800000,2248000,552378560,-552000,549578560
5,3,1572,-37.9233,144.9944,3700000,2248000,1348006784,-1452000,1344306784
4,2,605,-37.916,145.0064,2475000,2248000,580834816,-227000,578359816
4,2,732,-37.8987,144.9953,2700000,2248000,681193920,-452000,678493920
4,2,842,-37.9227,145.0043,3900000,2248000,768135104,-1652000,764235104
2,1,0,-37.9156,145.0013,610000,835500,98375200,225500,97765200
2,1,411,-37.9095,145.004,1532000,2248000,423188960,716000,421656960
2,1,125,-37.9078,145.0051,1037000,2248000,197163968,1211000,196126968
4,4,578,-37.8989,145.0008,3050000,2248000,562677888,-802000,559627888
4,2,432,-37.9228,145.0022,1630000,2248000,444111392,618000,442481392
4,2,848,-37.9234,145.0042,2640000,2248000,772876928,-392000,770236928
1,1,70,-37.9194,145.0003,671000,2248000,152329728,1577000,151658728
4,2,230,-37.9237,145.0056,2250000,2248000,284473184,-2000,282223184
3,1,659,-37.919,144.9953,2900000,2248000,620545024,-652000,617645024
4,1,695,-37.9262,144.9969,2405000,2248000,650363840,-157000,647958840
3,2,280,-37.91,144.989,1352500,2248000,322610112,895500,321257612
5,2,1045,-37.9205,145.0012,3105000,2248000,929929856,-857000,926824856
4,2,549,-37.8869,144.9982,1500000,2248000,536569600,748000,535069600
4,2,682,-37.9205,145.0122,1940000,2248000,641691968,308000,639751968
4,2,617,-37.9187,145.007,1850000,2248000,590319104,398000,588469104
3,1,329,-37.9317,145.0218,930000,2248000,359764256,1318000,358834256
4,3,618,-37.9162,145.0219,1310000,2248000,592711552,938000,591401552
4,2,674,-37.9022,145.0125,2504000,2248000,635367552,-256000,632863552
2,1,649,-37.9153,145.0142,1445000,2248000,611286976,803000,609841976
4,3,594,-37.9029,145.0118,1825000,2248000,573736640,423000,571911640
5,2,994,-37.9187,145.0187,1700000,2248000,889635200,548000,887935200
5,3,824,-37.9091,145.0245,1400000,2248000,756880064,848000,755480064
3,2,315,-37.9199,145.0174,1500000,2248000,350289216,748000,348789216
3,1,613,-37.9177,145.0143,1400000,2248000,584202880,848000,582802880
5,2,616,-37.9084,145.0221,1600000,2248000,590903040,648000,589303040
2,3,635,-37.9205,145.0102,1780000,2248000,603407552,468000,601627552
5,2,775,-37.932,145.0284,1200000,2248000,716567232,1048000,715367232
2,1,112,-37.9306,145.0284,775000,2248000,186907088,1473000,186132088
3,2,697,-37.9269,145.0274,1480000,2248000,652190336,768000,650710336
3,3,481,-37.931,145.0198,1590000,2248000,483074880,658000,481484880
4,2,999,-37.9135,145.0189,2840000,2248000,892219968,-592000,889379968
2,1,564,-37.9143,145.0238,1000000,2248000,544117376,1248000,543117376
4,3,708,-37.9299,145.015,1700000,2248000,663835840,548000,662135840
5,5,1561,-37.9102,145.0245,3207000,2248000,1342516992,-959000,1339309992
3,2,304,-37.9308,145.0316,880000,2248000,341605952,1368000,340725952
4,1,1000,-37.931,145.0163,1920000,2248000,891417472,328000,889497472
3,2,401,-37.9062,145.0173,1301000,2248000,418253216,947000,416952216
5,3,915,-37.9231,145.0104,2550000,2248000,828790272,-302000,826240272
5,2,645,-37.9175,145.0116,1915000,2248000,613816384,333000,611901384
4,3,598,-37.9075,145.0248,1650000,2248000,576906368,598000,575256368
4,2,603,-37.9187,145.0071,1530000,2248000,579254976,718000,577724976
4,2,678,-37.9255,145.0118,2050000,2248000,638531072,198000,636481072
5,3,551,-37.9176,145.009,2550000,2248000,541120000,-302000,538570000
2,1,189,-37.9172,145.0072,905000,2248000,247745456,1343000,246840456
3,1,759,-37.9057,145.0166,1355000,2248000,699586432,893000,698231432
2,1,604,-37.9268,145.0094,1845000,2248000,575721920,403000,573876920
5,3,669,-37.9289,145.0284,2050000,2248000,634388544,198000,632338544
3,3,435,-37.91,145.0113,1710000,2248000,446713408,538000,445003408
3,2,337,-37.9196,145.0205,1300000,2248000,367677664,948000,366377664
4,2,654,-37.9292,145.0236,2200000,2248000,619571584,48000,617371584
4,3,614,-37.9186,145.0175,2150000,2248000,589547968,98000,587397968
1,1,166,-37.9159,145.019,681000,2248000,228209520,1567000,227528520
2,3,302,-37.9182,145.0231,1310000,2248000,340245728,938000,338935728
1,1,0,-37.9164,145.0228,340000,835500,97022312,495500,96682312
2,1,74,-37.9207,145.0079,692000,2248000,156861968,1556000,156169968
4,2,315,-37.9078,145.0222,1367000,2248000,351656928,881000,350289928
2,1,171,-37.9125,145.0114,903000,2248000,233522144,1345000,232619144
4,4,509,-37.9172,145.0214,2820000,2248000,508162048,-572000,505342048
2,1,660,-37.9179,145.0127,1813000,2248000,619979648,435000,618166648
5,2,679,-37.9291,145.0283,1655000,2248000,640698176,593000,639043176
3,2,297,-37.9124,145.0132,1230000,2248000,336060320,1018000,334830320
4,1,656,-37.9027,145.0225,1389000,2248000,619555072,859000,618166072
4,2,757,-37.9266,145.0088,2310000,2248000,700962944,-62000,698652944
2,1,267,-37.9055,145.0173,1014000,2248000,309393632,1234000,308379632
2,1,225,-37.7676,144.9665,1026000,2248000,276153632,1222000,275127632
4,3,238,-37.7713,144.9643,1802500,2248000,292345504,445500,290543004
4,3,365,-37.7624,144.9671,1500000,2248000,392714176,748000,391214176
4,2,851,-37.7637,144.9662,2230000,2248000,775205632,18000,772975632
2,1,0,-37.7695,144.9528,410000,835500,98328184,425500,97918184
1,1,0,-37.762,144.9647,272500,835500,96968408,563000,96695908
3,3,81,-37.7575,144.9647,680000,2248000,166901040,1568000,166221040
2,1,0,-37.7608,144.968,400000,835500,98336512,435500,97936512
3,1,170,-37.7661,144.9691,950000,2248000,234054800,1298000,233104800
2,1,179,-37.7742,144.9542,845500,2248000,239793056,1402500,238947556
2,1,0,-37.7588,144.9646,605000,835500,98334184,230500,97729184
2,1,0,-37.7643,144.9638,445000,835500,98334344,390500,97889344
2,1,100,-37.7601,144.9581,659500,2248000,177360208,1588500,176700708
2,1,0,-37.777,144.9703,600000,835500,98339840,235500,97739840
4,1,264,-37.7611,144.9677,1115000,2248000,309707616,1133000,308592616
3,1,278,-37.7701,144.9633,1125000,2248000,319403968,1123000,318278968
3,1,229,-37.7622,144.9586,855000,2248000,280675520,1393000,279820520
3,2,186,-37.7581,144.9514,940000,2248000,248281040,1308000,247341040
2,2,118,-37.7723,144.9643,750000,2248000,193184080,1498000,192434080
2,1,315,-37.757,144.9697,1056000,2248000,347281216,1192000,346225216
3,2,122,-37.7697,144.9649,880000,2248000,197711584,1368000,196831584
3,1,331,-37.7619,144.959,1222500,2248000,361286208,1025500,360063708
3,2,327,-37.7636,144.9559,955000,2248000,359716576,1293000,358761576
2,1,114,-37.758,144.9667,587000,2248000,188429456,1661000,187842456
3,1,257,-37.7704,144.9695,1060000,2248000,302811552,1188000,301751552
2,1,199,-37.7676,144.9659,890000,2248000,255605472,1358000,254715472
2,2,0,-37.7617,144.9642,685000,835500,99927560,150500,99242560
3,2,240,-37.756,144.9587,976000,2248000,290961440,1272000,289985440
3,2,0,-37.7703,144.9533,641000,835500,101288056,194500,100647056
2,1,152,-37.7611,144.966,770000,2248000,218460720,1478000,217690720
1,1,0,-37.7597,144.9548,279500,835500,96962056,556000,96682556
4,2,271,-37.7769,144.9691,1800000,2248000,316835680,448000,315035680
4,1,370,-37.7728,144.9639,1350000,2248000,393478368,898000,392128368
4,2,281,-37.7722,144.9681,1320000,2248000,324737600,928000,323417600
3,1,210,-37.7597,144.9545,825000,2248000,265656976,1423000,264831976
3,1,216,-37.7746,144.9697,1261000,2248000,270409920,987000,269148920
3,1,222,-37.7642,144.969,1045000,2248000,275150080,1203000,274105080
3,1,0,-37.773,144.9624,1044000,835500,99700712,-208500,98656712
3,1,239,-37.7776,144.963,1050000,2248000,288583008,1198000,287533008
3,2,470,-37.7788,144.9688,1691500,2248000,472739040,556500,471047540
2,1,311,-37.7572,144.9687,1075000,2248000,344119488,1173000,343044488
2,1,1140,-37.7634,144.9616,501000,2248000,999273472,1747000,998772472
3,1,563,-37.7757,144.9505,1260000,2248000,544631936,988000,543371936
3,1,495,-37.7702,144.9672,1650000,2248000,490901216,598000,489251216
2,1,0,-37.7778,144.9594,601000,835500,98333216,234500,97732216
2,1,453,-37.762,144.9547,1015000,2248000,456333824,1233000,455318824
1,1,82,-37.7661,144.9614,625000,2248000,161771344,1623000,161146344
3,2,0,-37.7763,144.9597,1700000,835500,101292704,-864500,99592704
2,1,0,-37.7597,144.9655,435000,835500,98334840,400500,97899840
5,2,555,-37.7767,144.9645,2500000,2248000,542643968,-252000,540143968
2,1,298,-37.7704,144.9504,860000,2248000,333835840,1388000,332975840
2,1,1080,-37.7598,144.9655,491000,2248000,951857472,1757000,951366472
3,1,384,-37.7626,144.9535,985000,2248000,403168736,1263000,402183736
3,1,483,-37.7602,144.9543,1250000,2248000,481408512,998000,480158512
3,2,0,-37.7703,144.9533,641000,835500,101288056,194500,100647056
3,1,184,-37.7563,144.96,860000,2248000,245112256,1388000,244252256
2,1,161,-37.7646,144.9586,705000,2248000,225569264,1543000,224864264
3,1,264,-37.7603,144.9573,880000,2248000,308334976,1368000,307454976
2,2,177,-37.7625,144.9653,754000,2248000,239811216,1494000,239057216
2,1,0,-37.7703,144.9533,590000,835500,98328584,245500,97738584
2,1,0,-37.7775,144.9607,575000,835500,98333984,260500,97758984
3,1,325,-37.7621,144.9595,1510000,2248000,356544736,738000,355034736
2,2,156,-37.7744,144.9498,801000,2248000,223206784,1447000,222405784
3,2,4668,-37.7687,144.9649,820000,2248000,3790409984,1428000,3789589984
1,1,540,-37.7766,144.9574,370000,2248000,523726976,1878000,523356976
3,1,285,-37.7634,144.9593,1170000,2248000,324932832,1078000,323762832
4,1,416,-37.7737,144.965,1790000,2248000,429832928,458000,428042928
3,2,110,-37.7776,144.9691,640000,2248000,188231504,1608000,187591504
4,2,657,-37.7725,144.964,1875000,2248000,621887360,373000,620012360
3,1,343,-37.7589,144.9529,1053000,2248000,370765664,1195000,369712664
3,1,55,-37.7611,144.9622,705000,2248000,143165600,1543000,142460600
4,1,363,-37.7621,144.9506,1217000,2248000,387936800,1031000,386719800
3,1,308,-37.7649,144.9641,1020000,2248000,343112864,1228000,342092864
3,1,316,-37.7741,144.9703,1340000,2248000,349440096,908000,348100096
4,2,460,-37.7554,144.9544,1410000,2248000,466190656,838000,464780656
3,1,346,-37.7738,144.9695,1550000,2248000,373148512,698000,371598512
3,2,4676,-37.7687,144.9649,740000,2248000,3796732416,1508000,3795992416
2,1,0,-37.7706,144.9608,592500,835500,98333232,243000,97740732
1,1,0,-37.7775,144.9607,370000,835500,96967768,465500,96597768
2,1,199,-37.759,144.9597,765000,2248000,255600656,1483000,254835656
1,1,147,-37.7643,144.9584,772000,2248000,213138720,1476000,212366720
3,2,280,-37.7719,144.9661,1210000,2248000,322579776,1038000,321369776
4,2,354,-37.7745,144.9523,1755000,2248000,382419904,493000,380664904
2,1,246,-37.775,144.9536,945000,2248000,292742816,1303000,291797816
2,1,159,-37.7656,144.9562,755000,2248000,223987328,1493000,223232328
2,1,0,-37.768,144.9408,521500,835500,98320616,314000,97799116
3,1,0,-37.7564,144.9422,1190000,835500,99686328,-354500,98496328
2,1,564,-37.7665,144.9425,471000,2248000,544049984,1777000,543578984
1,1,0,-37.7586,144.9452,265000,835500,96956016,570500,96691016
3,1,220,-37.7659,144.9494,955000,2248000,273557568,1293000,272602568
5,2,510,-37.7581,144.9414,1350000,2248000,507064128,898000,505714128
2,1,0,-37.7607,144.9393,380000,835500,98318832,455500,97938832
1,1,0,-37.7763,144.947,300000,835500,96959200,535500,96659200
3,1,349,-37.7589,144.9368,810000,2248000,375497536,1438000,374687536
3,1,275,-37.763,144.9439,793000,2248000,317020320,1455000,316227320
2,1,73,-37.7528,144.9368,400000,2248000,156008160,1848000,155608160
2,1,0,-37.7582,144.94,400500,835500,98318984,435000,97918484
3,2,262,-37.7519,144.9324,797500,2248000,308331296,1450500,307533796
3,1,364,-37.7618,144.9497,1300000,2248000,387360320,948000,386060320
3,1,353,-37.764,144.9428,1330000,2248000,378663040,918000,377333040
7,3,447,-37.7634,144.9403,1205000,2248000,461600928,1043000,460395928
2,1,0,-37.7676,144.9394,380000,835500,98319704,455500,97939704
3,1,411,-37.7728,144.9478,1095000,2248000,424504512,1153000,423409512
2,1,0,-37.772,144.9406,680000,835500,98320968,155500,97640968
2,1,177,-37.7619,144.9412,711000,2248000,238203008,1537000,237492008
2,1,0,-37.7595,144.9436,500000,835500,98321352,335500,97821352
2,1,0,-37.7688,144.9421,385000,835500,98321512,450500,97936512
2,1,2120,-37.7524,144.9347,370000,2248000,1773748608,1878000,1773378608
1,1,0,-37.7661,144.9422,320000,835500,96955048,515500,96635048
1,1,0,-37.7748,144.9483,330000,835500,96959816,505500,96629816
5,2,553,-37.7576,144.9348,1200000,2248000,541042880,1048000,539842880
2,1,501,-37.7741,144.9449,537000,2248000,494263520,1711000,493726520
3,1,717,-37.7525,144.9321,910000,2248000,666323904,1338000,665413904
1,1,0,-37.7675,144.939,285000,835500,96953240,550500,96668240
4,1,575,-37.7575,144.9402,921500,2248000,555473216,1326500,554551716
2,1,554,-37.7715,144.9426,1315000,2248000,536147680,933000,534832680
2,1,0,-37.7606,144.9443,370000,835500,98321904,465500,97951904
2,1,120,-37.7659,144.9487,735000,2248000,193161088,1513000,192426088
4,1,589,-37.7628,144.9459,1000000,2248000,566541568,1248000,565541568
1,1,0,-37.7586,144.9433,252000,835500,96954840,583500,96702840
4,2,621,-37.7764,144.9479,1700000,2248000,593427200,548000,591727200
2,1,206,-37.7604,144.9488,820000,2248000,261126192,1428000,260306192
2,1,0,-37.7686,144.9421,370000,835500,98321480,465500,97951480
2,1,0,-37.7543,144.9385,484000,835500,98317592,351500,97833592
3,1,157,-37.7652,144.9454,815000,2248000,223766224,1433000,222951224
4,1,519,-37.7747,144.9474,1150000,2248000,511222912,1098000,510072912
2,1,0,-37.7647,144.9412,497000,835500,98320464,338500,97823464
2,1,0,-37.7577,144.9354,440000,835500,98316088,395500,97876088
2,2,343,-37.7552,144.9458,816000,2248000,370988000,1432000,370172000
4,3,499,-37.7538,144.944,970000,2248000,498598944,1278000,497628944
3,1,385,-37.7599,145.0849,851000,2248000,404039584,1397000,403188584
4,1,717,-37.7608,145.0862,1300000,2248000,667785856,948000,666485856
4,2,556,-37.7657,145.0957,1235000,2248000,542147456,1013000,540912456
4,2,670,-37.7695,145.0869,1303000,2248000,632236608,945000,630933608
3,2,514,-37.7683,145.0959,880000,2248000,507589152,1368000,506709152
3,2,632,-37.7813,145.102,975000,2248000,600849728,1273000,599874728
3,2,585,-37.7689,145.099,990000,2248000,563702400,1258000,562712400
4,2,723,-37.7724,145.1033,1225000,2248000,674132800,1023000,672907800
5,3,796,-37.7697,145.0871,1490000,2248000,734773888,758000,733283888
3,3,401,-37.7733,145.0901,905000,2248000,419875712,1343000,418970712
4,2,1124,-37.7679,145.0958,1085000,2248000,991037504,1163000,989952504
3,1,306,-37.7792,145.0903,787000,2248000,341611584,1461000,340824584
3,1,604,-37.7711,145.0928,1075000,2248000,577121216,1173000,576046216
4,2,475,-37.765,145.0933,1302000,2248000,478131744,946000,476829744
3,2,728,-37.7765,145.1031,1050000,2248000,676718464,1198000,675668464
4,2,672,-37.7689,145.0895,1000000,2248000,633818688,1248000,632818688
4,2,744,-37.7791,145.086,1300000,2248000,690719296,948000,689419296
3,1,602,-37.7674,145.0988,990000,2248000,575543808,1258000,574553808
4,2,693,-37.7743,145.0863,1100000,2248000,650413696,1148000,649313696
2,1,591,-37.7679,145.0978,903000,2248000,565483776,1345000,564580776
5,3,661,-37.848,145.098,1590000,2248000,628099392,658000,626509392
4,2,1145,-37.8538,145.127,1890000,2248000,1007663104,358000,1005773104
3,2,265,-37.8516,145.1056,1022500,2248000,310820544,1225500,309798044
3,1,931,-37.854,145.1195,1755000,2248000,835575168,493000,833820168
3,1,667,-37.8489,145.1093,1300000,2248000,626929344,948000,625629344
3,1,786,-37.8525,145.1198,1160000,2248000,720981824,1088000,719821824
4,3,928,-37.842,145.102,2000000,2248000,837744832,248000,835744832
3,1,318,-37.8544,145.1114,790000,2248000,351117024,1458000,350327024
4,2,921,-37.8494,145.1291,1682000,2248000,830636928,566000,828954928
3,2,0,-37.8561,145.0962,625000,835500,101386104,210500,100761104
2,1,194,-37.8509,145.1119,650000,2248000,251753616,1598000,251103616
5,3,326,-37.8528,145.1129,1060000,2248000,363359104,1188000,362299104
4,2,438,-37.8599,145.1101,1255000,2248000,448912192,993000,447657192
2,1,276,-37.8454,145.0971,633000,2248000,316548384,1615000,315915384
2,1,593,-37.8444,145.1054,1350000,2248000,567078080,898000,565728080
3,1,384,-37.8542,145.1138,570000,2248000,403278144,1678000,402708144
3,1,228,-37.8521,145.1187,745000,2248000,279994304,1503000,279249304
5,4,643,-37.8454,145.0974,2150000,2248000,615466688,98000,613316688
3,1,308,-37.8505,145.1065,746000,2248000,343210528,1502000,342464528
3,2,653,-37.8445,145.1011,1540000,2248000,617452928,708000,615912928
4,2,399,-37.8597,145.1084,1270000,2248000,418089472,978000,416819472
4,3,381,-37.8459,145.1041,900000,2248000,405453056,1348000,404553056
4,2,499,-37.8593,145.1101,1250000,2248000,497120352,998000,495870352
4,2,739,-37.8552,145.1292,1410000,2248000,686803328,838000,685393328
4,2,0,-37.8507,145.109,800000,835500,102759552,35500,101959552
3,2,170,-37.8554,145.1089,702000,2248000,235744624,1546000,235042624
4,2,652,-37.8286,145.0686,2650000,2248000,618006912,-402000,615356912
2,1,137,-37.8459,145.088,729000,2248000,206691280,1519000,205962280
5,4,708,-37.8386,145.067,2600000,2248000,666816576,-352000,664216576
3,2,305,-37.8365,145.0802,1650000,2248000,342415104,598000,340765104
2,1,1107,-37.8347,145.057,615000,2248000,973260736,1633000,972645736
3,2,706,-37.8457,145.0611,1987000,2248000,659314240,261000,657327240
2,1,146,-37.8357,145.0697,683000,2248000,213791520,1565000,213108520
3,2,777,-37.8431,145.0962,1690000,2248000,715446784,558000,713756784
2,1,0,-37.8493,145.0877,430000,835500,98420592,405500,97990592
4,2,600,-37.8237,145.0638,2600000,2248000,576907840,-352000,574307840
3,2,1133,-37.8426,145.0943,2325000,2248000,996791936,-77000,994466936
2,1,896,-37.8479,145.0958,435000,2248000,806533056,1813000,806098056
3,1,821,-37.8459,145.0644,2000000,2248000,748607360,248000,746607360
3,1,427,-37.8367,145.0934,1302000,2248000,437246400,946000,435944400
3,1,544,-37.8436,145.0581,1622000,2248000,529690464,626000,528068464
2,1,0,-37.8255,145.0592,502000,835500,98400248,333500,97898248
2,1,896,-37.8479,145.0958,435000,2248000,806533120,1813000,806098120
3,1,0,-37.8255,145.0592,591000,835500,99766464,244500,99175464
5,2,730,-37.8424,145.0639,2608000,2248000,681015104,-360000,678407104
3,1,769,-37.8482,145.0949,1780000,2248000,707530816,468000,705750816
3,2,656,-37.841,145.0824,2250000,2248000,619811776,-2000,617561776
2,1,424,-37.8465,145.0743,895000,2248000,433498688,1353000,432603688
3,2,584,-37.8349,145.0758,1800000,2248000,562905536,448000,561105536
2,1,150,-37.8438,145.066,900000,2248000,216951392,1348000,216051392
5,3,802,-37.8442,145.0578,2700000,2248000,739506432,-452000,736806432
2,1,0,-37.8491,145.086,530000,835500,98419512,305500,97889512
4,2,813,-37.8405,145.0903,2228000,2248000,745259776,20000,743031776
3,1,405,-37.8448,145.071,1602500,2248000,419847008,645500,418244508
3,1,635,-37.8454,145.0707,2177000,2248000,601615552,71000,599438552
3,2,877,-37.8437,145.0623,3400000,2248000,794455808,-1152000,791055808
3,1,692,-37.8379,145.0849,2105000,2248000,646670528,143000,644565528
3,2,283,-37.8362,145.064,1625000,2248000,325018464,623000,323393464
3,3,417,-37.831,145.0621,3300000,2248000,432510048,-1052000,429210048
2,1,83,-37.8355,145.0633,667000,2248000,163998736,1581000,163331736
4,1,772,-37.8441,145.0806,2015000,2248000,711258688,233000,709243688
2,1,631,-37.8434,145.081,700000,2248000,597094336,1548000,596394336
4,3,632,-37.8244,145.064,3225000,2248000,603790912,-977000,600565912
5,4,741,-37.8422,145.064,3320000,2248000,692894976,-1072000,689574976
5,3,603,-37.8437,145.069,2125000,2248000,582243712,123000,580118712
4,2,686,-37.8458,145.0611,2030000,2248000,644874432,218000,642844432
4,3,0,-37.8325,145.0649,2750000,835500,104323536,-1914500,101573536
4,3,697,-37.836,145.056,2000000,2248000,655156672,248000,653156672
5,5,639,-37.8303,145.0668,2250000,2248000,613878144,-2000,611628144
5,2,643,-37.8421,145.0719,2740000,2248000,612264064,-492000,609524064
4,2,687,-37.8186,145.0706,2950000,2248000,645667456,-702000,642717456
3,1,459,-37.8265,145.072,1587500,2248000,462521600,660500,460934100
2,1,110,-37.8264,145.0824,830000,2248000,185347504,1418000,184517504
4,2,653,-37.8292,145.0852,2375000,2248000,618807488,-127000,616432488
5,2,795,-37.8181,145.0668,2900000,2248000,732383488,-652000,729483488
3,3,468,-37.8264,145.0741,2200000,2248000,472822112,48000,470622112
4,1,717,-37.8266,145.0849,2620000,2248000,667792832,-372000,665172832
2,1,342,-37.8326,145.081,1305000,2248000,368696672,943000,367391672
3,2,145,-37.8233,145.0769,928000,2248000,215963664,1320000,215035664
5,3,645,-37.8317,145.0738,2930000,2248000,615437888,-682000,612507888
4,2,812,-37.8323,145.0842,2950000,2248000,744464704,-702000,741514704
2,1,0,-37.8205,145.0828,722000,835500,98414184,113500,97692184
5,2,838,-37.8252,145.0721,2350000,2248000,766370432,-102000,764020432
3,3,352,-37.827,145.0737,1640000,2248000,381147264,608000,379507264
3,2,325,-37.826,145.0729,1680000,2248000,358215328,568000,356535328
5,4,684,-37.832,145.0853,3550000,2248000,647859904,-1302000,644309904
4,1,845,-37.8184,145.0702,3400000,2248000,768941056,-1152000,765541056
3,2,361,-37.8206,145.0785,1850000,2248000,386668896,398000,384818896
4,2,796,-37.8266,145.072,3145000,2248000,731811776,-897000,728666776
4,3,122,-37.7893,144.9696,1425000,2248000,200676240,823000,199251240
3,1,499,-37.7811,144.9715,2950000,2248000,494066336,-702000,491116336
4,1,418,-37.7808,144.9736,2175000,2248000,431419616,73000,429244616
2,1,73,-37.7852,144.9719,800000,2248000,156033568,1448000,155233568
4,2,538,-37.7816,144.9714,2718000,2248000,527847520,-470000,525129520
2,2,413,-37.7875,144.9759,2400000,2248000,426331200,-152000,423931200
4,2,504,-37.7805,144.9721,2520000,2248000,500977568,-272000,498457568
3,2,84,-37.7879,144.9736,2050000,2248000,167687696,198000,165637696
4,2,207,-37.7804,144.9748,1950000,2248000,266260512,298000,264310512
1,1,0,-37.7798,144.9707,437000,835500,96974192,398500,96537192
2,1,0,-37.7813,144.9773,520000,835500,98344648,315500,97824648
2,1,0,-37.7902,144.97,570000,835500,98341192,265500,97771192
3,1,0,-37.897,145.0623,820000,835500,99776768,15500,98956768
2,2,133,-37.8911,145.0539,795000,2248000,205107680,1453000,204312680
2,1,73,-37.897,145.0593,600000,2248000,156100528,1648000,155500528
3,1,425,-37.8876,145.0502,1295000,2248000,435645184,953000,434350184
2,1,0,-37.8912,145.0644,510000,835500,98411176,325500,97901176
1,1,60,-37.8965,145.0618,346000,2248000,144461904,1902000,144115904
3,2,1113,-37.8972,145.0642,860000,2248000,980973888,1388000,980113888
2,1,0,-37.8863,145.066,772000,835500,98411568,63500,97639568
4,2,561,-37.8934,145.0633,1506000,2248000,546094080,742000,544588080
3,2,0,-37.8972,145.0642,675000,835500,101371224,160500,100696224
2,1,0,-37.8893,145.0589,525000,835500,98407560,310500,97882560
1,1,0,-37.8858,145.0632,290000,835500,97043592,545500,96753592
2,1,0,-37.9032,145.0555,360000,835500,98407096,475500,98047096
2,1,299,-37.8973,145.053,967500,2248000,334704192,1280500,333736692
1,1,0,-37.8888,145.0533,330000,835500,97037848,505500,96707848
3,2,751,-37.8945,145.0648,1600000,2248000,694885696,648000,693285696
3,2,300,-37.8974,145.0539,1008000,2248000,338454560,1240000,337446560
3,1,0,-37.8977,145.0493,1170000,835500,99768840,-334500,98598840
4,2,687,-37.8931,145.0479,1830000,2248000,645662208,418000,643832208
1,1,0,-37.8982,145.0625,250000,835500,97044608,585500,96794608
2,2,166,-37.8982,145.0488,930000,2248000,231185264,1318000,230255264
2,1,0,-37.8881,145.0558,465000,835500,98405512,370500,97940512
4,2,757,-37.8925,145.0541,1550000,2248000,700986752,698000,699436752
2,1,144,-37.892,145.0482,707000,2248000,212204304,1541000,211497304
2,2,0,-37.9,145.0548,804000,835500,99999560,31500,99195560
4,2,598,-37.9037,145.0588,1501000,2248000,575333568,747000,573832568
3,2,325,-37.8933,145.0546,970000,2248000,358211968,1278000,357241968
2,1,211,-37.8856,145.0599,817500,2248000,265160784,1430500,264343284
4,2,557,-37.8955,145.0515,1450000,2248000,542925824,798000,541475824
2,1,158,-37.8886,145.052,855000,2248000,223270416,1393000,222415416
2,1,0,-37.8973,145.0625,675000,835500,98410712,160500,97735712
2,1,133,-37.89,145.0559,588000,2248000,203515504,1660000,202927504
2,1,0,-37.8897,145.0524,455000,835500,98403608,380500,97948608
3,2,283,-37.8974,145.0622,920000,2248000,325024576,1328000,324104576
2,1,103,-37.8873,145.0559,656000,2248000,179806224,1592000,179150224
2,1,264,-37.8864,145.0561,930000,2248000,307044352,1318000,306114352
2,1,0,-37.8889,145.048,415000,835500,98400808,420500,97985808
2,1,174,-37.8978,145.062,650000,2248000,235922448,1598000,235272448
3,2,282,-37.8953,145.0567,1360000,2248000,324230656,888000,322870656
1,1,0,-37.8894,145.0508,350000,835500,97036368,485500,96686368
3,2,603,-37.9023,145.0568,1430000,2248000,577917440,818000,576487440
3,2,371,-37.8871,145.052,1490000,2248000,394563392,758000,393073392
3,1,604,-37.8993,145.0528,1125000,2248000,577111616,1123000,575986616
2,1,967,-37.8843,145.0531,405000,2248000,862622272,1843000,862217272
4,2,595,-37.8916,145.0543,1655000,2248000,572958464,593000,571303464
3,1,111,-37.8889,145.0495,808000,2248000,187491088,1440000,186683088
2,1,0,-37.8959,145.0639,370000,835500,98411416,465500,98041416
4,2,932,-37.8975,145.0478,1880000,2248000,839285888,368000,837405888
2,1,108,-37.8973,145.0596,585000,2248000,183761184,1663000,183176184
2,1,0,-37.8999,145.0575,450000,835500,98407944,385500,97957944
3,1,277,-37.8978,145.0624,860000,2248000,318689664,1388000,317829664
2,1,0,-37.8956,145.0613,605000,835500,98409776,230500,97804776
4,3,454,-37.8869,145.0628,1518000,2248000,463124256,730000,461606256
2,1,99,-37.8946,145.0588,632500,2248000,176647696,1615500,176015196
2,1,0,-37.8986,145.0567,435000,835500,98407304,400500,97972304
2,1,912,-37.8936,145.056,468250,2248000,819158784,1779750,818690534
3,2,817,-37.9007,145.047,1716000,2248000,747035136,532000,745319136
1,1,0,-37.8887,145.048,365000,835500,97034568,470500,96669568
2,1,0,-37.8865,145.0302,722500,835500,98389568,113000,97667068
2,1,806,-37.8852,145.024,550000,2248000,735366528,1698000,734816528
4,1,499,-37.8864,145.0242,131000,2248000,495477344,2117000,495346344
3,2,692,-37.8629,145.019,1750000,2248000,648226112,498000,646476112
2,1,934,-37.8607,145.0116,580000,2248000,836514240,1668000,835934240
3,2,361,-37.8694,145.0296,2005000,2248000,386644544,243000,384639544
2,1,0,-37.861,145.0136,420000,835500,98376344,415500,97956344
1,1,952,-37.8744,145.0371,290000,2248000,849390528,1958000,849100528
3,1,270,-37.868,145.0269,1400000,2248000,313132224,848000,311732224
2,1,1092,-37.8647,145.0232,450000,2248000,961388992,1798000,960938992
2,1,771,-37.8686,145.0239,536000,2248000,707703936,1712000,707167936
2,1,0,-37.8609,145.0126,550000,835500,98375728,285500,97825728
4,2,810,-37.8698,145.0325,2170000,2248000,742856768,78000,740686768
3,2,357,-37.8896,145.0307,1577500,2248000,383486368,670500,381908868
3,1,451,-37.8874,145.019,1460000,2248000,456173728,788000,454713728
1,1,0,-37.8961,145.0132,275500,835500,97014024,560000,96738524
2,1,273,-37.895,145.022,1065000,2248000,314137088,1183000,313072088
4,2,216,-37.8887,145.0318,1030000,2248000,273421056,1218000,272391056
2,1,284,-37.8958,145.0215,1225000,2248000,322830176,1023000,321605176
3,2,478,-37.8893,145.0161,1450000,2248000,479103488,798000,477653488
4,2,575,-37.8993,145.0254,1774500,2248000,557135616,473500,555361116
2,1,831,-37.8974,145.0294,525500,2248000,755128640,1722500,754603140
2,1,367,-37.8995,145.0241,825000,2248000,388426976,1423000,387601976
2,2,464,-37.8901,145.0224,1262000,2248000,466677088,986000,465415088
2,1,505,-37.8928,145.0149,1340000,2248000,497481760,908000,496141760
3,2,494,-37.9027,145.0322,1200000,2248000,491759776,1048000,490559776
2,2,255,-37.8887,145.0207,1001000,2248000,301503424,1247000,300502424
3,1,312,-37.8893,145.0196,1330000,2248000,346322784,918000,344992784
4,2,641,-37.9012,145.035,1570000,2248000,609301440,678000,607731440
4,2,630,-37.8894,145.0145,1916000,2248000,600594112,332000,598678112
4,3,288,-37.8801,145.1051,890000,2248000,331959904,1358000,331069904
3,2,224,-37.8738,145.1054,700000,2248000,278420768,1548000,277720768
3,2,277,-37.8796,145.1044,865000,2248000,320306656,1383000,319441656
4,3,209,-37.8805,145.105,1042500,2248000,269526304,1205500,268483804
2,1,585,-37.8792,145.0948,1002000,2248000,560753216,1246000,559751216
3,2,160,-37.8859,145.0934,650000,2248000,227835680,1598000,227185680
4,3,273,-37.8742,145.105,965000,2248000,320104672,1283000,319139672
3,1,620,-37.8812,145.105,1301000,2248000,589786432,947000,588485432
4,2,1033,-37.8738,145.1095,1415500,2248000,919141312,832500,917725812
4,2,500,-37.8845,145.1027,1260000,2248000,497909056,988000,496649056
3,1,630,-37.8838,145.102,1000000,2248000,597687936,1248000,596687936
3,2,177,-37.8824,145.1042,845000,2248000,241276992,1403000,240431992
4,2,188,-37.8781,145.0955,881000,2248000,251330624,1367000,250449624
2,1,155,-37.7934,144.9922,780000,2248000,220851536,1468000,220071536
3,1,193,-37.7899,144.9984,1060000,2248000,252252512,1188000,251192512
3,2,124,-37.7934,144.9923,930000,2248000,199311808,1318000,198381808
2,1,174,-37.7928,144.9987,1075000,2248000,235871152,1173000,234796152
2,1,185,-37.7927,144.9981,1105000,2248000,244564032,1143000,243459032
2,1,140,-37.7919,144.9884,1209000,2248000,208994560,1039000,207785560
4,3,382,-37.7897,144.9992,3010000,2248000,406172192,-762000,403162192
2,1,239,-37.7918,144.997,1435000,2248000,287239392,813000,285804392
2,1,164,-37.7912,144.9967,1290000,2248000,227966752,958000,226676752
2,1,515,-37.7875,145.0049,495000,2248000,505366240,1753000,504871240
3,2,176,-37.7921,144.9898,1370000,2248000,240405664,878000,239035664
2,1,156,-37.7892,144.9999,1450000,2248000,221646080,798000,220196080
2,2,0,-37.7937,144.9983,885500,835500,99952312,-50000,99066812
3,3,67,-37.7946,144.9989,825000,2248000,155862256,1423000,155037256
4,2,162,-37.7885,144.9994,1506000,2248000,230713168,742000,229207168
3,1,118,-37.7921,144.9858,1360000,2248000,192972608,888000,191612608
2,1,371,-37.735,144.9589,850000,2248000,391528736,1398000,390678736
3,1,286,-37.7427,144.952,784000,2248000,325716192,1464000,324932192
3,1,702,-37.7391,144.9812,680000,2248000,654498048,1568000,653818048
2,2,0,-37.7546,144.9713,807000,835500,99931088,28500,99124088
3,1,142,-37.7382,144.973,675000,2248000,211925568,1573000,211250568
3,2,423,-37.7493,144.9559,1202000,2248000,435583552,1046000,434381552
3,1,233,-37.7549,144.9611,1370000,2248000,283837376,878000,282467376
3,2,370,-37.744,144.9501,1000000,2248000,393693568,1248000,392693568
4,1,536,-37.7555,144.9658,145000,2248000,524667136,2103000,524522136
3,1,283,-37.7416,144.9582,860000,2248000,323348960,1388000,322488960
2,1,170,-37.7508,144.9608,953000,2248000,232681680,1295000,231728680
2,1,280,-37.7429,144.952,735000,2248000,319608224,1513000,318873224
3,1,372,-37.735,144.9581,947000,2248000,393684736,1301000,392737736
2,1,0,-37.7405,144.9644,500000,835500,98331912,335500,97831912
2,1,0,-37.7527,144.9522,466000,835500,98325832,369500,97859832
3,2,255,-37.7546,144.9713,740000,2248000,302823488,1508000,302083488
3,1,370,-37.7561,144.9718,812000,2248000,392115008,1436000,391303008
3,1,378,-37.7561,144.9716,766000,2248000,398437280,1482000,397671280
3,1,374,-37.7561,144.9715,825000,2248000,395276096,1423000,394451096
4,2,494,-37.7359,144.9711,1131000,2248000,493068832,1117000,491937832
3,2,417,-37.7478,144.9583,1064000,2248000,430843104,1184000,429779104
3,1,379,-37.7544,144.9764,1210000,2248000,399230368,1038000,398020368
2,1,0,-37.7405,144.9644,434000,835500,98331912,401500,97897912
2,1,129,-37.7422,144.9606,653000,2248000,200278304,1595000,199625304
3,1,119,-37.7403,144.9491,640000,2248000,193734224,1608000,193094224
3,1,735,-37.7379,144.9623,1130000,2248000,680566080,1118000,679436080
3,2,107,-37.7517,144.963,763000,2248000,185853792,1485000,185090792
2,1,253,-37.7484,144.9521,903000,2248000,298270880,1345000,297367880
3,1,431,-37.75,144.9695,1000000,2248000,440321120,1248000,439321120
4,2,482,-37.7529,144.9534,1742000,2248000,483576320,506000,481834320
4,1,452,-37.7525,144.948,865000,2248000,458270688,1383000,457405688
2,2,0,-37.7367,144.9701,485000,835500,99928240,350500,99443240
3,2,405,-37.7464,144.959,1278000,2248000,421359744,970000,420081744
3,2,0,-37.7458,144.9751,590000,835500,101298592,245500,100708592
4,3,420,-37.7501,144.962,1136000,2248000,436176000,1112000,435040000
2,1,97,-37.7516,144.9623,635000,2248000,174990880,1613000,174355880
4,1,856,-37.7432,144.9481,1400000,2248000,777550400,848000,776150400
3,2,407,-37.7471,144.9579,1260000,2248000,422939744,988000,421679744
3,1,385,-37.734,144.9603,841000,2248000,403959840,1407000,403118840
2,1,0,-37.7435,144.9563,537500,835500,98327280,298000,97789780
2,1,108,-37.7379,144.9617,598000,2248000,183682208,1650000,183084208
3,2,293,-37.7481,144.9663,1120000,2248000,332850976,1128000,331730976
3,1,371,-37.735,144.9558,870000,2248000,392892992,1378000,392022992
3,1,462,-37.7448,144.9478,680000,2248000,464806432,1568000,464126432
3,1,577,-37.7459,144.9773,825000,2248000,555709120,1423000,554884120
3,1,238,-37.7539,144.9612,725000,2248000,287788832,1523000,287063832
4,3,515,-37.7537,144.9766,1250000,2248000,511263776,998000,510013776
2,1,457,-37.7505,144.9725,1008000,2248000,459504640,1240000,458496640
4,1,488,-37.7537,144.9532,990000,2248000,486724800,1258000,485734800
2,1,0,-37.752,144.954,451000,835500,98326848,384500,97875848
2,2,339,-37.7404,144.9559,635000,2248000,367831232,1613000,367196232
5,2,381,-37.7492,144.969,1020000,2248000,405131520,1228000,404111520
3,1,336,-37.7408,144.9558,1025000,2248000,365233248,1223000,364208248
3,1,138,-37.7406,144.9555,700000,2248000,208753872,1548000,208053872
3,1,206,-37.7382,144.9563,1130000,2248000,262494416,1118000,261364416
4,1,531,-37.7473,144.9528,1075000,2248000,520706624,1173000,519631624
3,1,102,-37.736,144.9665,600000,2248000,180309344,1648000,179709344
4,2,43,-37.7456,144.9469,1150000,2248000,136630256,1098000,135480256
2,1,0,-37.7474,144.9608,515000,835500,98330504,320500,97815504
2,1,500,-37.747,144.9515,472000,2248000,493474144,1776000,493002144
2,1,545,-37.7445,144.9471,901000,2248000,529034528,1347000,528133528
2,1,0,-37.7519,144.9721,605000,835500,98337992,230500,97732992
3,1,116,-37.7454,144.9487,687000,2248000,191363680,1561000,190676680
4,2,307,-37.748,144.9602,975000,2248000,345277632,1273000,344302632
3,1,563,-37.7493,144.978,1370000,2248000,544645760,878000,543275760
2,1,381,-37.74,144.9516,700000,2248000,399427808,1548000,398727808
3,2,213,-37.7461,144.9584,810000,2248000,269622016,1438000,268812016
4,1,576,-37.7369,144.9637,838000,2248000,556275648,1410000,555437648
4,1,633,-37.7531,144.9504,1150000,2248000,601316288,1098000,600166288
4,1,412,-37.7432,144.9768,931000,2248000,426675392,1317000,425744392
1,1,0,-37.7463,144.9635,241000,835500,96965824,594500,96724824
2,1,263,-37.7493,144.97,981000,2248000,306184960,1267000,305203960
2,1,0,-37.7367,144.9701,570000,835500,98334960,265500,97764960
2,1,113,-37.7424,144.961,500000,2248000,187633792,1748000,187133792
3,1,404,-37.7305,144.9803,655000,2248000,418987456,1593000,418332456
3,1,178,-37.7297,144.9645,631000,2248000,240370048,1617000,239739048
2,1,145,-37.7295,144.9641,600000,2248000,212923744,1648000,212323744
3,2,173,-37.7308,144.9832,715000,2248000,238023504,1533000,237308504
3,1,565,-37.7283,144.969,864000,2248000,546218304,1384000,545354304
3,1,626,-37.7201,144.9696,700000,2248000,594425920,1548000,593725920
2,1,0,-37.721,144.9527,591000,835500,98322416,244500,97731416
3,1,586,-37.7205,144.9659,860000,2248000,562811776,1388000,561951776
2,1,563,-37.723,144.96,765000,2248000,543265344,1483000,542500344
3,1,104,-37.7307,144.9826,625000,2248000,181899232,1623000,181274232
2,1,526,-37.732,144.9832,745000,2248000,514039648,1503000,513294648
4,3,501,-37.7266,144.9823,1050000,2248000,500199968,1198000,499149968
2,1,833,-37.7297,144.9654,935000,2248000,756650112,1313000,755715112
2,1,629,-37.7276,144.9688,820000,2248000,595430976,1428000,594610976
3,1,307,-37.7215,144.9533,780000,2248000,342310784,1468000,341530784
3,2,556,-37.7305,144.9605,707000,2248000,540693888,1541000,539986888
3,1,498,-37.7323,144.9833,637000,2248000,493277568,1611000,492640568
4,2,298,-37.7308,144.9836,950000,2248000,338177280,1298000,337227280
3,2,472,-37.734,144.9728,860000,2248000,474316800,1388000,473456800
5,3,425,-37.7302,144.9816,1172000,2248000,441503456,1076000,440331456
3,1,407,-37.7351,144.9833,650000,2248000,421360704,1598000,420710704
4,2,320,-37.7242,144.9612,792000,2248000,355549344,1456000,354757344
3,1,499,-37.7236,144.9576,720000,2248000,494051040,1528000,493331040
3,1,575,-37.7307,144.9704,970000,2248000,554122368,1278000,553152368
2,1,178,-37.7974,144.9915,890000,2248000,239028432,1358000,238138432
2,1,0,-37.8042,144.9845,1260000,835500,98351776,-424500,97091776
2,1,2886,-37.8042,144.9845,855000,2248000,2379153920,1393000,2378298920
3,2,0,-37.8083,144.9908,1125000,835500,101315608,-289500,100190608
2,1,0,-37.8035,144.985,910000,835500,98352000,-74500,97442000
1,1,816,-37.802,144.9848,452000,2248000,741869376,1796000,741417376
1,1,3701,-37.809,144.9911,415000,2248000,3021885952,1833000,3021470952
1,1,0,-37.809,144.9911,372000,835500,96990184,463500,96618184
3,2,0,-37.8032,144.9842,1326000,835500,101310952,-490500,99984952
2,2,0,-37.8042,144.9845,1230000,835500,99945048,-394500,98715048
2,1,130,-37.7953,144.9882,855000,2248000,201091824,1393000,200236824
1,1,406,-37.796,144.9911,457000,2248000,417849984,1791000,417392984
3,2,82,-37.7961,144.9873,897500,2248000,166116496,1350500,165218996
2,1,282,-37.7985,144.9883,1265000,2248000,321217696,983000,319952696
3,1,183,-37.7948,144.9875,1075000,2248000,244343392,1173000,243268392
1,1,0,-37.796,144.9911,366000,835500,96988664,469500,96622664
2,1,188,-37.7964,144.9923,981000,2248000,246931792,1267000,245950792
2,1,0,-37.8035,144.985,683000,835500,98352000,152500,97669000
2,1,159,-37.7962,144.9887,1000000,2248000,224010928,1248000,223010928
3,2,81,-37.7961,144.9874,887500,2248000,165326272,1360500,164438772
2,2,1060,-37.7954,144.9868,713500,2248000,937662144,1534500,936948644
3,2,0,-37.8042,144.9845,1500000,835500,101311248,-664500,99811248
2,1,0,-37.8046,144.984,672000,835500,98351512,163500,97679512
2,1,0,-37.8026,144.9848,800000,835500,98351776,35500,97551776
2,1,0,-37.8046,144.9858,1645000,835500,98352608,-809500,96707608
2,2,0,-37.8035,144.985,860000,835500,99945272,-24500,99085272
3,1,727,-37.7942,145.1218,1403000,2248000,674348544,845000,672945544
3,1,638,-37.7912,145.1248,1450000,2248000,604013440,798000,602563440
4,1,658,-37.7827,145.1358,1396000,2248000,621191296,852000,619795296
3,2,819,-37.781,145.1036,1125000,2248000,748636544,1123000,747511544
3,2,0,-37.7862,145.1235,700000,835500,101394688,135500,100694688
4,2,336,-37.794,145.1178,1152000,2248000,368298720,1096000,367146720
4,2,925,-37.7869,145.1183,1868000,2248000,833784192,380000,831916192
4,2,317,-37.7815,145.1279,1050000,2248000,353287744,1198000,352237744
3,2,299,-37.7929,145.1338,910000,2248000,337701152,1338000,336791152
3,1,1073,-37.7772,145.1157,1850000,2248000,947786048,398000,945936048
4,3,740,-37.7912,145.1127,1225000,2248000,689169216,1023000,687944216
4,2,716,-37.778,145.1173,1316000,2248000,668609984,932000,667293984
5,3,656,-37.7752,145.1317,1400000,2248000,624160128,848000,622760128
5,5,669,-37.7808,145.1185,2168000,2248000,637613056,80000,635445056
4,2,655,-37.782,145.1194,1430000,2248000,620403648,818000,618973648
3,2,203,-37.7776,145.1267,772000,2248000,261826304,1476000,261054304
4,2,806,-37.7939,145.1392,1468000,2248000,739752256,780000,738284256
4,1,241,-37.7743,145.1093,753000,2248000,291619520,1495000,290866520
3,2,118,-37.7863,145.106,746000,2248000,194639168,1502000,193893168
3,2,731,-37.7892,145.131,1485000,2248000,679108096,763000,677623096
3,1,658,-37.7816,145.1066,1190000,2248000,619807040,1058000,618617040
3,2,366,-37.792,145.1077,900000,2248000,390634976,1348000,389734976
3,2,728,-37.7813,145.1318,1250000,2248000,676736704,998000,675486704
3,1,827,-37.7848,145.1029,1030000,2248000,753365632,1218000,752335632
4,2,182,-37.7888,145.138,985000,2248000,246604480,1263000,245619480
3,1,651,-37.7827,145.1051,1300000,2248000,614274176,948000,612974176
4,3,654,-37.7795,145.1294,1462500,2248000,621212416,785500,619749916
3,2,900,-37.7902,145.1344,1250000,2248000,812670784,998000,811420784
4,3,654,-37.7856,145.1088,1460800,2248000,621200448,787200,619739648
3,2,648,-37.7798,145.1368,1152500,2248000,613515776,1095500,612363276
5,4,500,-37.7863,145.1105,1650000,2248000,502455040,598000,500805040
3,1,764,-37.7934,145.1207,1391000,2248000,703588800,857000,702197800
2,1,67,-37.7887,145.1436,452000,2248000,151397872,1796000,150945872
3,2,233,-37.7881,145.1371,1102200,2248000,285542880,1145800,284440680
4,3,650,-37.7785,145.1212,1401000,2248000,618046080,847000,616645080
4,3,586,-37.7739,145.1287,1782000,2248000,567471040,466000,565689040
4,3,657,-37.7954,145.1379,1520000,2248000,623590336,728000,622070336
3,2,0,-37.7901,145.1341,878000,835500,101401664,-42500,100523664
4,2,234,-37.7932,145.1275,973500,2248000,287694112,1274500,286720612
3,1,109,-37.7749,145.1138,751800,2248000,185936672,1496200,185184872
3,2,771,-37.7765,145.117,1100000,2248000,710709952,1148000,709609952
3,2,649,-37.7794,145.1224,1202000,2248000,614297088,1046000,613095088
3,1,798,-37.7894,145.1333,1362000,2248000,730466240,886000,729104240
4,2,769,-37.7781,145.1337,1810000,2248000,710506048,438000,708696048
5,2,963,-37.7674,145.0518,1901000,2248000,865138496,347000,863237496
4,3,724,-37.7594,145.0594,1650000,2248000,676487872,598000,674837872
3,1,846,-37.7666,145.0591,1816000,2248000,768352192,432000,766536192
2,1,79,-37.7612,145.0663,525000,2248000,160830656,1723000,160305656
4,3,723,-37.7615,145.0705,2050000,2248000,675704640,198000,673654640
5,2,939,-37.7659,145.0585,1930000,2248000,846175168,318000,844245168
4,2,871,-37.7612,145.0676,2600000,2248000,791073792,-352000,788473792
2,1,112,-37.7669,145.0521,600000,2248000,186902448,1648000,186302448
3,1,872,-37.7618,145.0649,1601000,2248000,788903040,647000,787302040
3,2,555,-37.7585,145.0568,1100000,2248000,539966208,1148000,538866208
4,2,1484,-37.769,145.0616,2550000,2248000,1275524224,-302000,1272974224
3,2,0,-37.7623,145.0569,1190000,835500,101350888,-354500,100160888
4,3,597,-37.765,145.0646,2012000,2248000,576123776,236000,574111776
4,3,1177,-37.7652,145.0687,2309000,2248000,1034499776,-61000,1032190776
2,1,239,-37.8845,144.999,900000,2248000,287251520,1348000,286351520
3,2,447,-37.8912,145.0138,1625000,2248000,454603008,623000,452978008
4,2,147,-37.8852,144.9997,1100000,2248000,218870224,1148000,217770224
3,2,391,-37.8885,145.0133,1755000,2248000,410345728,493000,408590728
4,1,489,-37.8916,145.0123,1400000,2248000,487567680,848000,486167680
3,2,319,-37.8922,145.0112,1240000,2248000,353443360,1008000,352203360
2,1,815,-37.8857,145.0136,591000,2248000,742472768,1657000,741881768
2,1,0,-37.8838,145.0095,537000,835500,98376520,298500,97839520
3,2,331,-37.8847,144.9992,800000,2248000,362918688,1448000,362118688
3,1,275,-37.8859,144.9994,965000,2248000,317068896,1283000,316103896
2,2,155,-37.8887,145.0046,1160000,2248000,222463648,1088000,221303648
3,2,108,-37.8858,145.0012,820000,2248000,186683392,1428000,185863392
4,2,527,-37.883,145.0043,2600000,2248000,519186400,-352000,516586400
3,2,179,-37.8961,145.0125,1071000,2248000,242802768,1177000,241731768
3,2,492,-37.8789,145.0048,1800000,2248000,490159520,448000,488359520
3,2,419,-37.8817,145.0126,2345000,2248000,432472864,-97000,430127864
2,1,0,-37.8829,145.0033,741000,835500,98372576,94500,97631576
2,1,1764,-37.8889,145.0043,626000,2248000,1492460928,1622000,1491834928
4,3,386,-37.883,144.999,1650000,2248000,409344256,598000,407694256
3,2,108,-37.8861,145.0014,850000,2248000,186683536,1398000,185833536
3,2,517,-37.8813,145.0063,1750000,2248000,509918240,498000,508168240
3,1,351,-37.8832,145.0133,1450000,2248000,377139872,798000,375689872
4,3,669,-37.8871,145.0081,2806000,2248000,633004800,-558000,630198800
3,1,0,-37.8921,145.0106,782000,835500,99744368,53500,98962368
4,2,125,-37.8855,145.001,1007000,2248000,201484512,1241000,200477512
4,2,376,-37.892,145.008,1450000,2248000,399854528,798000,398404528
2,1,0,-37.8822,144.9994,500000,835500,98370104,335500,97870104
4,3,701,-37.8897,145.008,2600000,2248000,658294720,-352000,655694720
2,1,147,-37.8849,144.9993,895000,2248000,214544272,1353000,213649272
4,3,420,-37.8891,145.0102,2050000,2248000,436222016,198000,434172016
3,1,418,-37.8831,145.0153,1605000,2248000,430091104,643000,428486104
1,1,0,-37.8761,144.9871,520000,835500,96995608,315500,96475608
2,1,0,-37.8752,144.9911,507000,835500,98364176,328500,97857176
2,1,553,-37.8802,144.9942,525000,2248000,535401888,1723000,534876888
2,1,0,-37.8791,144.9923,750000,835500,98365368,85500,97615368
1,1,0,-37.8857,144.9884,510000,835500,96997528,325500,96487528
1,1,0,-37.8749,144.9842,300000,835500,96993680,535500,96693680
3,2,400,-37.8829,144.9797,1395000,2248000,417437056,853000,416042056
2,1,1966,-37.8725,144.9848,855000,2248000,1652087424,1393000,1651232424
2,1,0,-37.8794,144.9938,790000,835500,98366336,45500,97576336
2,1,0,-37.8839,144.9855,550000,835500,98361744,285500,97811744
1,1,0,-37.8785,144.9885,357000,835500,96996752,478500,96639752
2,1,163,-37.8778,144.9904,1210000,2248000,227182752,1038000,225972752
2,1,0,-37.874,144.9819,825000,835500,98358368,10500,97533368
3,1,257,-37.881,144.9841,1050000,2248000,302833536,1198000,301783536
2,1,0,-37.8831,144.9855,632000,835500,98361664,203500,97729664
1,1,0,-37.8831,144.9918,485000,835500,96999328,350500,96514328
2,1,483,-37.874,144.9835,575000,2248000,480073664,1673000,479498664
2,1,0,-37.8757,144.9853,590000,835500,98360672,245500,97770672
3,2,116,-37.8789,144.9836,1238000,2248000,192994112,1010000,191756112
2,1,0,-37.8831,144.9896,510000,835500,98364176,325500,97854176
4,2,223,-37.882,144.993,1875000,2248000,278928448,373000,277053448
3,1,0,-37.8726,144.9846,780000,835500,99726080,55500,98946080
3,2,75,-37.8843,144.9917,878500,2248000,160597488,1369500,159718988
3,2,737,-37.8839,144.9831,3572000,2248000,683769984,-1324000,680197984
2,1,0,-37.8751,144.987,560000,835500,98361640,275500,97801640
2,1,0,-37.8809,144.9833,765000,835500,98360048,70500,97595048
2,2,0,-37.883,144.9916,670000,835500,99958672,165500,99288672
3,2,246,-37.8861,144.9877,1625000,2248000,295736320,623000,294111320
2,2,0,-37.8744,144.9888,1122000,835500,99955944,-286500,98833944
4,2,560,-37.8822,144.9913,2400000,2248000,545258112,-152000,542858112
2,1,0,-37.8902,144.9907,655000,835500,98365696,180500,97710696
2,1,0,-37.875,144.991,684000,835500,98364088,151500,97680088
2,1,0,-37.8761,144.9821,500000,835500,98358744,335500,97858744
2,1,0,-37.8811,144.9797,680000,835500,98357856,155500,97677856
2,1,0,-37.8715,144.9873,600000,835500,98361400,235500,97761400
1,1,0,-37.8767,144.9849,370000,835500,96994328,465500,96624328
1,1,644,-37.8798,144.994,390000,2248000,605952704,1858000,605562704
2,1,0,-37.8817,144.984,630000,835500,98360560,205500,97730560
2,1,0,-37.8757,144.987,640000,835500,98361712,195500,97721712
2,2,799,-37.8818,144.9918,932000,2248000,731407424,1316000,730475424
2,1,0,-37.8842,144.9829,645000,835500,98360184,190500,97715184
1,1,0,-37.8839,144.9903,347000,835500,96998488,488500,96651488
2,1,0,-37.8725,144.9854,875000,835500,98360352,-39500,97485352
2,1,0,-37.8895,144.9902,582500,835500,98365304,253000,97782804
2,1,0,-37.8831,144.9855,570000,835500,98361664,265500,97791664
4,3,235,-37.8775,144.9808,1875000,2248000,289997280,373000,288122280
1,1,0,-37.8784,144.9864,340000,835500,96995448,495500,96655448
4,3,348,-37.8748,144.9778,2200000,2248000,379298848,48000,377098848
2,1,0,-37.8828,144.9899,687500,835500,98364320,148000,97676820
2,1,0,-37.874,144.9903,730000,835500,98363536,105500,97633536
2,1,0,-37.8809,144.9947,526000,835500,98367056,309500,97841056
3,2,758,-37.8768,144.9845,920000,2248000,700366272,1328000,699446272
3,2,374,-37.8747,144.987,1830000,2248000,396892800,418000,395062800
3,2,684,-37.7585,144.9317,1425000,2248000,641837696,823000,640412696
2,1,263,-37.7418,144.8977,660000,2248000,306139584,1588000,305479584
2,1,0,-37.7575,144.9298,550000,835500,98312608,285500,97762608
3,1,688,-37.7578,144.9317,1295000,2248000,643405568,953000,642110568
2,1,752,-37.7553,144.9302,595000,2248000,692617280,1653000,692022280
3,2,225,-37.7454,144.8987,911000,2248000,279068736,1337000,278157736
4,2,288,-37.7562,144.9286,900000,2248000,330243424,1348000,329343424
2,1,0,-37.7495,144.9205,645000,835500,98305952,190500,97660952
2,1,168,-37.758,144.9311,702500,2248000,231083664,1545500,230381164
3,1,549,-37.7479,144.8931,960000,2248000,533529152,1288000,532569152
4,2,291,-37.7544,144.9325,1670000,2248000,332616512,578000,330946512
3,2,789,-37.7558,144.9073,1100000,2248000,724803840,1148000,723703840
4,2,648,-37.7493,144.9112,1800000,2248000,614739520,448000,612939520
4,3,374,-37.7507,144.8911,1250000,2248000,399778720,998000,398528720
2,1,646,-37.7502,144.8923,1130000,2248000,608821632,1118000,607691632
2,1,0,-37.7569,144.9256,370000,835500,98309952,465500,97939952
3,2,188,-37.7532,144.9178,1467000,2248000,249840352,781000,248373352
5,4,877,-37.7491,144.9002,2800000,2248000,800263936,-552000,797463936
4,3,256,-37.7527,144.8957,1160000,2248000,306526528,1088000,305366528
6,4,860,-37.7484,144.9025,2620000,2248000,788196352,-372000,785576352
3,1,533,-37.7462,144.8953,1226000,2248000,520885568,1022000,519659568
4,2,554,-37.7508,144.8937,1402000,2248000,540440832,846000,539038832
3,1,396,-37.7484,144.8907,855000,2248000,412612000,1393000,411757000
4,2,503,-37.7513,144.8925,1275000,2248000,500134912,973000,498859912
4,3,475,-37.7418,144.8938,1590000,2248000,479599488,658000,478009488
2,1,0,-37.7598,144.9128,606000,835500,98302408,229500,97696408
3,2,619,-37.7543,144.9318,1385000,2248000,590467840,863000,589082840
3,2,160,-37.7403,144.8989,650000,2248000,227698848,1598000,227048848
2,1,0,-37.7545,144.8964,460000,835500,98291696,375500,97831696
3,2,291,-37.7499,144.8927,1000000,2248000,331225312,1248000,330225312
2,1,0,-37.7486,144.9072,520000,835500,98297664,315500,97777664
3,1,190,-37.7418,144.8918,720000,2248000,249810352,1528000,249090352
4,1,638,-37.7523,144.9052,1635000,2248000,605239872,613000,603604872
2,1,0,-37.7504,144.9138,485000,835500,98301928,350500,97816928
5,3,700,-37.7461,144.9173,1575000,2248000,658797888,673000,657222888
1,1,0,-37.7475,144.9194,280000,835500,96938832,555500,96658832
4,2,683,-37.7439,144.9195,1467000,2248000,642404416,781000,640937416
2,1,649,-37.7445,144.9133,890000,2248000,611204864,1358000,610314864
2,1,319,-37.7555,144.9118,870000,2248000,350406624,1378000,349536624
3,1,551,-37.7571,144.9335,1134000,2248000,535135648,1114000,534001648
1,1,0,-37.7547,144.9107,320500,835500,96934312,515000,96613812
2,1,477,-37.7503,144.911,1065000,2248000,475272672,1183000,474207672
4,2,601,-37.7434,144.9256,1610000,2248000,577603648,638000,575993648
2,1,225,-37.7548,144.9113,930000,2248000,276118144,1318000,275188144
2,1,0,-37.7461,144.9058,395000,835500,98296504,440500,97901504
3,1,687,-37.7442,144.9045,1470000,2248000,642596928,778000,641126928
3,1,253,-37.7397,144.898,750000,2248000,299602720,1498000,298852720
2,1,0,-37.7554,144.9127,390000,835500,98301848,445500,97911848
4,2,0,-37.7465,144.91,1170000,835500,102624824,-334500,101454824
4,3,519,-37.7517,144.9086,1600000,2248000,514382880,648000,512782880
4,1,638,-37.7523,144.9052,1535000,2248000,605239872,713000,603704872
2,1,0,-37.7461,144.9079,435000,835500,98297792,400500,97862792
3,2,605,-37.7546,144.9042,1460000,2248000,579386752,788000,577926752
2,1,0,-37.7412,144.8974,736000,835500,98290752,99500,97554752
2,1,0,-37.745,144.915,450000,835500,98302032,385500,97852032
2,1,250,-37.7457,144.9061,740000,2248000,295871328,1508000,295131328
2,1,201,-37.7454,144.928,691000,2248000,257160128,1557000,256469128
4,2,715,-37.7582,144.9128,2355000,2248000,667691520,-107000,665336520
3,2,858,-37.7417,144.8961,1625000,2248000,779325888,623000,777700888
3,1,300,-37.7548,144.9315,1150000,2248000,336769216,1098000,335619216
2,1,0,-37.754,144.9209,360000,835500,98306720,475500,97946720
2,1,170,-37.7475,144.8959,645000,2248000,232641344,1603000,231996344
1,1,0,-37.7523,144.9221,250000,835500,96941056,585500,96691056
3,1,862,-37.7399,144.8964,872000,2248000,780893696,1376000,780021696
2,1,0,-37.7543,144.9066,630000,835500,98297952,205500,97667952
2,1,1011,-37.7556,144.9132,440000,2248000,897294208,1808000,896854208
5,3,657,-37.7548,144.9098,1811000,2248000,624811456,437000,623000456
3,2,440,-37.7524,144.9074,1500000,2248000,448989184,748000,447489184
3,1,618,-37.7442,144.9249,1290000,2248000,588078848,958000,586788848
3,1,0,-37.7566,144.9155,1100000,835500,99669920,-264500,98569920
4,2,411,-37.757,144.9251,1270000,2248000,427448096,978000,426178096
3,2,400,-37.7542,144.9117,1445000,2248000,417380064,803000,415935064
4,1,533,-37.7509,144.8922,1113000,2248000,522250336,1135000,521137336
2,1,0,-37.7482,144.908,370000,835500,98298112,465500,97928112
2,1,0,-37.7428,144.9086,396000,835500,98297848,439500,97901848
2,1,88,-37.7389,144.8998,450000,2248000,167838240,1798000,167388240
5,3,463,-37.7379,144.9022,1360000,2248000,471486848,888000,470126848
2,1,0,-37.7433,144.9074,340000,835500,98297152,495500,97957152
3,2,0,-37.7364,144.8977,765000,835500,101249864,70500,100484864
3,2,189,-37.7374,144.9006,712000,2248000,250618240,1536000,249906240
3,2,327,-37.7723,145.0179,1250000,2248000,359755744,998000,358505744
3,1,309,-37.7828,145.0154,1350000,2248000,343936800,898000,342586800
2,1,537,-37.7689,145.0177,1220000,2248000,522758496,1028000,521538496
4,2,381,-37.7735,145.0192,1160000,2248000,403799040,1088000,402639040
2,1,0,-37.7755,145.0178,505000,835500,98368896,330500,97863896
2,1,0,-37.7845,145.0105,602000,835500,98365448,233500,97763448
3,1,185,-37.7665,145.0175,846000,2248000,245939120,1402000,245093120
2,1,0,-37.7719,145.0195,400000,835500,98369520,435500,97969520
2,1,0,-37.7782,145.0162,445000,835500,98368224,390500,97923224
4,2,490,-37.7749,145.0242,1730000,2248000,489944832,518000,488214832
2,1,1658,-37.7781,145.0157,510000,2248000,1408683392,1738000,1408173392
3,1,553,-37.7728,145.0214,1350000,2248000,536772192,898000,535422192
4,3,575,-37.7671,145.0176,2000000,2248000,558708544,248000,556708544
2,1,140,-37.7697,145.0203,805000,2248000,209011568,1443000,208206568
3,1,382,-37.7696,145.0188,1055000,2248000,401629152,1193000,400574152
2,1,0,-37.7845,145.0105,548000,835500,98365448,287500,97817448
3,1,0,-37.7714,145.0173,1500000,835500,99734304,-664500,98234304
2,1,0,-37.7732,145.0193,600000,835500,98369544,235500,97769544
2,1,0,-37.7682,145.0209,545000,835500,98369952,290500,97824952
3,1,496,-37.7737,145.018,1375000,2248000,491723232,873000,490348232
3,2,0,-37.8029,144.975,1252000,835500,101305256,-416500,100053256
2,1,0,-37.7941,144.9802,810000,835500,98347928,25500,97537928
1,1,87,-37.8019,144.9821,947500,2248000,165739792,1300500,164792292
2,1,0,-37.8006,144.9814,1460000,835500,98349432,-624500,96889432
2,2,0,-37.7953,144.9775,880000,835500,99939688,-44500,99059688
4,4,337,-37.8052,144.9739,3310000,2248000,372188320,-1062000,368878320
3,1,113,-37.7966,144.9821,1250000,2248000,189019344,998000,187769344
4,1,177,-37.7999,144.9759,1950000,2248000,240961264,298000,239011264
1,1,0,-37.7974,144.9799,465000,835500,96981920,370500,96516920
4,2,132,-37.8004,144.9768,1620000,2248000,206991712,628000,205371712
3,2,2782,-37.8005,144.9787,850000,2248000,2299918592,1398000,2299068592
2,1,106,-37.7968,144.9781,1122000,2248000,182118608,1126000,180996608
2,1,157,-37.7941,144.98,1300000,2248000,222424704,948000,221124704
1,1,782,-37.8055,144.9809,420000,2248000,714997120,1828000,714577120
2,1,0,-37.7967,144.9836,715000,835500,98350328,120500,97635328
2,2,64,-37.7956,144.9804,800000,2248000,150520608,1448000,149720608
2,1,0,-37.7953,144.9775,710000,835500,98346408,125500,97636408
2,1,0,-37.8024,144.9835,630000,835500,98350944,205500,97720944
4,3,286,-37.7999,144.9755,4011000,2248000,330290144,-1763000,326279144
2,2,4332,-37.7846,144.9785,700000,2248000,3523513344,1548000,3522813344
2,1,104,-37.7927,144.9796,860000,2248000,180538464,1388000,179678464
2,1,107,-37.7898,144.9794,870000,2248000,182908880,1378000,182038880
4,2,266,-37.7797,144.9861,1450000,2248000,312895040,798000,311445040
1,1,0,-37.7925,144.9786,358500,835500,96980560,477000,96622060
2,2,134,-37.7916,144.9784,770000,2248000,205839840,1478000,205069840
2,1,150,-37.7833,144.9819,1008000,2248000,216892528,1240000,215884528
3,2,112,-37.7912,144.9825,1015000,2248000,189821936,1233000,188806936
3,1,197,-37.7835,144.9816,1371000,2248000,255402608,877000,254031608
3,1,275,-37.7779,144.9862,1286000,2248000,317048096,962000,315762096
3,3,188,-37.7829,144.9788,1600000,2248000,251474672,648000,249874672
4,2,233,-37.7786,144.9818,1950000,2248000,286812384,298000,284862384
4,2,445,-37.786,144.9864,3400000,2248000,454359488,-1152000,450959488
4,2,188,-37.7815,144.9869,1785000,2248000,251252416,463000,249467416
2,1,223,-37.7829,144.9782,1210000,2248000,274582016,1038000,273372016
3,2,104,-37.7813,144.9834,1275000,2248000,183498960,973000,182223960
2,1,136,-37.7819,144.9824,1290000,2248000,205828480,958000,204538480
2,2,0,-37.7761,144.9792,750000,835500,99938480,85500,99188480
2,1,0,-37.7918,144.9824,675000,835500,98349024,160500,97674024
4,3,127,-37.7855,144.9789,1700000,2248000,204633040,548000,202933040
3,2,77,-37.7923,144.9776,1080000,2248000,162158592,1168000,161078592
2,1,487,-37.7737,144.9822,1222500,2248000,483222272,1025500,481999772
2,1,100,-37.788,144.9791,937500,2248000,177376400,1310500,176438900
3,1,203,-37.7834,144.9862,1300000,2248000,260147232,948000,258847232
3,2,127,-37.7851,144.9809,1300000,2248000,201674736,948000,200374736
3,2,202,-37.7835,144.9867,2150000,2248000,260950496,98000,258800496
3,1,193,-37.7836,144.985,1581000,2248000,252243504,667000,250662504
2,1,0,-37.7794,144.989,602000,835500,98351624,233500,97749624
2,1,0,-37.777,144.9838,650000,835500,98348144,185500,97698144
3,2,118,-37.7839,144.9807,1450000,2248000,194561776,798000,193111776
2,1,0,-37.7833,144.9255,365000,835500,98313000,470500,97948000
2,1,0,-37.7833,144.9255,425000,835500,98313000,410500,97888000
2,1,0,-37.7825,144.9239,391000,835500,98311928,444500,97920928
3,1,294,-37.7856,144.9292,1130000,2248000,332029600,1118000,330899600
3,1,272,-37.7857,144.931,1110000,2248000,314644160,1138000,313534160
2,1,136,-37.7839,144.9343,918000,2248000,205799120,1330000,204881120
2,1,140,-37.7867,144.9342,730000,2248000,208960576,1518000,208230576
2,1,225,-37.7849,144.9197,855000,2248000,276126848,1393000,275271848
3,1,212,-37.7818,144.9247,1012000,2248000,267221872,1236000,266209872
2,1,0,-37.7833,144.9255,395000,835500,98313000,440500,97918000
2,2,0,-37.784,144.9356,556000,835500,99912568,279500,99356568
1,1,0,-37.7826,144.9311,345000,835500,96950160,490500,96605160
3,2,179,-37.7857,144.9305,1100000,2248000,242739312,1148000,241639312
1,1,818,-37.788,144.9306,395000,2248000,743414912,1853000,743019912
3,1,244,-37.7823,144.9278,1115000,2248000,292513408,1133000,291398408
2,1,0,-37.783,144.932,420500,835500,98316968,415000,97896468
4,2,319,-37.7943,144.8875,1225000,2248000,354721888,1023000,353496888
3,1,292,-37.797,144.9051,1003000,2248000,330435520,1245000,329432520
3,1,164,-37.7959,144.8863,840000,2248000,229265552,1408000,228425552
3,2,497,-37.7958,144.9024,1362000,2248000,494038272,886000,492676272
4,2,154,-37.7983,144.8911,977000,2248000,224325264,1271000,223348264
1,1,0,-37.7907,144.8924,216000,835500,96927280,619500,96711280
3,2,204,-37.8012,144.8921,876000,2248000,262474976,1372000,261598976
1,1,0,-37.7907,144.8924,227000,835500,96927280,608500,96700280
4,2,250,-37.7959,144.8989,841000,2248000,300198496,1407000,299357496
2,1,2794,-37.8044,144.9064,605000,2248000,2306398720,1643000,2305793720
2,1,47,-37.8014,144.8959,305000,2248000,135440928,1943000,135135928
2,1,556,-37.7919,144.8854,480000,2248000,537695424,1768000,537215424
3,1,361,-37.7913,144.8879,910000,2248000,384954848,1338000,384044848
1,1,665,-37.7978,144.8918,291000,2248000,622476416,1957000,622185416
2,1,215,-37.7922,144.891,752000,2248000,268207088,1496000,267455088
3,1,585,-37.7941,144.8924,1155000,2248000,561984832,1093000,560829832
3,1,0,-37.7962,144.8851,853000,835500,99655856,-17500,98802856
3,1,0,-37.7949,144.9007,480000,835500,99665288,355500,99185288
4,1,277,-37.7901,144.8883,775000,2248000,319936064,1473000,319161064
2,1,0,-37.7891,144.8912,281000,835500,98292568,554500,98011568
4,2,0,-37.7923,144.8848,1300000,835500,102614688,-464500,101314688
3,2,164,-37.7948,144.8868,714000,2248000,230859008,1534000,230145008
2,1,657,-37.7909,144.8884,950000,2248000,617517376,1298000,616567376
3,1,265,-37.7975,144.8894,760000,2248000,309087840,1488000,308327840
2,1,0,-37.8042,144.9049,420000,835500,98302776,415500,97882776
3,1,451,-37.8023,144.8915,932000,2248000,456085248,1316000,455153248
3,1,323,-37.7935,144.8893,780000,2248000,354924608,1468000,354144608
2,1,0,-37.7903,144.891,295000,835500,98292592,540500,97997592
2,1,0,-37.8017,144.8957,433000,835500,98296824,402500,97863824
2,2,65,-37.7881,144.8838,410000,2248000,151250592,1838000,150840592
2,1,184,-37.7988,144.902,1170000,2248000,243715312,1078000,242545312
1,1,0,-37.8006,144.881,375000,835500,96921432,460500,96546432
3,1,246,-37.8012,144.8924,747000,2248000,294074464,1501000,293327464
3,1,242,-37.7956,144.8848,775000,2248000,290907904,1473000,290132904
2,2,0,-37.8025,144.9073,571000,835500,99897328,264500,99326328
1,1,59,-37.7903,144.8899,305000,2248000,143553312,1943000,143248312
3,2,322,-37.7963,144.8862,860500,2248000,355726016,1387500,354865516
2,1,0,-37.7992,144.8961,370000,835500,98296776,465500,97926776
2,1,253,-37.7968,144.8887,711000,2248000,298237504,1537000,297526504
2,1,212,-37.7903,144.8879,690500,2248000,265834000,1557500,265143500
2,1,320,-37.7964,144.8871,747000,2248000,351186496,1501000,350439496
2,1,313,-37.7966,144.9016,858000,2248000,345663360,1390000,344805360
4,2,0,-37.7905,144.8882,699000,835500,102616568,136500,101917568
2,1,222,-37.7962,144.8844,835000,2248000,273735552,1413000,272900552
2,1,132,-37.7946,144.8903,661000,2248000,202612080,1587000,201951080
2,1,258,-37.7959,144.8901,757500,2248000,302189760,1490500,301432260
1,1,1783,-37.7949,144.9007,282000,2248000,1506035840,1966000,1505753840
3,1,125,-37.7922,144.8831,699000,2248000,198441472,1549000,197742472
3,1,190,-37.795,144.883,850000,2248000,249811168,1398000,248961168
2,1,882,-37.7899,144.893,315000,2248000,795337280,1933000,795022280
3,1,211,-37.8059,144.901,740000,2248000,266419840,1508000,265679840
3,2,196,-37.7987,144.9034,980000,2248000,256159264,1268000,255179264
2,1,0,-37.789,144.8932,316000,835500,98293792,519500,97977792
2,1,130,-37.7988,144.9045,760000,2248000,201040720,1488000,200280720
3,2,112,-37.8001,144.8797,735000,2248000,189759696,1513000,189024696
4,2,319,-37.7943,144.8875,1225000,2248000,354721888,1023000,353496888
3,2,458,-37.7942,144.8832,767500,2248000,463204544,1480500,462437044
2,2,0,-37.8006,144.9053,395000,835500,99895880,440500,99500880
4,2,369,-37.7914,144.8957,815000,2248000,394241504,1433000,393426504
3,2,102,-37.7987,144.8807,757000,2248000,181857184,1491000,181100184
4,1,799,-37.7958,144.9001,1450000,2248000,732480000,798000,731030000
2,1,355,-37.7931,144.8938,745000,2248000,378850720,1503000,378105720
2,1,274,-37.7939,144.8846,716000,2248000,314830944,1532000,314114944
3,2,680,-37.854,145.0832,1735000,2248000,638780992,513000,637045992
4,3,856,-37.8628,145.0436,3400000,2248000,780809728,-1152000,777409728
5,3,919,-37.8637,145.0438,3730000,2248000,831965056,-1482000,828235056
4,2,868,-37.8522,145.0893,1800000,2248000,788726912,448000,786926912
4,2,739,-37.8513,145.0601,1998000,2248000,686760320,250000,684762320
2,1,0,-37.8555,145.0889,671000,835500,98422064,164500,97751064
3,2,217,-37.8639,145.0641,1425000,2248000,272862080,823000,271437080
3,1,753,-37.8543,145.0889,1530000,2248000,694883072,718000,693353072
4,4,708,-37.8646,145.0673,1900000,2248000,665453568,348000,663553568
3,2,704,-37.852,145.0942,1360000,2248000,657754688,888000,656394688
5,3,619,-37.8554,145.0611,2175000,2248000,594885056,73000,592710056
4,3,638,-37.8523,145.0726,2325000,2248000,608541248,-77000,606216248
4,2,630,-37.856,145.0691,2538000,2248000,600623872,-290000,598085872
4,3,1258,-37.8552,145.082,2300000,2248000,1098532608,-52000,1096232608
2,1,0,-37.8567,145.0435,550000,835500,98394256,285500,97844256
3,2,704,-37.852,145.0942,1600000,2248000,657754688,648000,656154688
3,2,745,-37.8501,145.059,2115000,2248000,690135104,133000,688020104
3,2,625,-37.8602,145.0925,1700000,2248000,595320960,548000,593620960
4,2,553,-37.8589,145.0413,2077000,2248000,539754048,171000,537677048
4,3,1184,-37.8526,145.0848,2850000,2248000,1040051904,-602000,1037201904
2,1,0,-37.85,145.0461,411000,835500,98395064,424500,97984064
4,2,630,-37.8667,145.0752,2020000,2248000,600628800,228000,598608800
4,2,659,-37.8509,145.0916,2010000,2248000,623555776,238000,621545776
4,3,0,-37.8541,145.0643,2975000,835500,104325712,-2139500,101350712
1,1,63,-37.8552,145.05,452000,2248000,146820688,1796000,146368688
3,1,650,-37.8571,145.0766,1820000,2248000,613475072,428000,611655072
1,1,1097,-37.8576,145.0452,291000,2248000,963986944,1957000,963695944
4,2,652,-37.8479,145.0557,2376000,2248000,618001216,-128000,615625216
3,1,504,-37.8541,145.0544,1456000,2248000,498077440,792000,496621440
1,1,745,-37.8505,145.0459,345000,2248000,685801408,1903000,685456408
5,3,696,-37.8563,145.0709,2000000,2248000,655744192,248000,653744192
2,1,84,-37.8517,145.0796,585000,2248000,164800976,1663000,164215976
4,3,650,-37.8581,145.078,1700000,2248000,618028800,548000,616328800
3,2,328,-37.8529,145.0605,1375000,2248000,360581728,873000,359206728
2,1,334,-37.8577,145.0576,920000,2248000,362362880,1328000,361442880
2,1,1069,-37.8547,145.0457,382000,2248000,943224704,1866000,942842704
2,1,412,-37.8541,145.051,1280000,2248000,424001664,968000,422721664
5,4,802,-37.8627,145.0719,2825000,2248000,741110528,-577000,738285528
3,2,885,-37.8577,145.0421,2825000,2248000,800767424,-577000,797942424
4,3,366,-37.8503,145.0586,1825000,2248000,393571104,423000,391746104
5,3,778,-37.8582,145.0715,3085000,2248000,720549248,-837000,717464248
2,2,718,-37.858,145.0696,1600000,2248000,667438272,648000,665838272
5,3,642,-37.859,145.0656,2352500,2248000,613065088,-104500,610712588
5,4,830,-37.8563,145.072,3860000,2248000,763238272,-1612000,759378272
4,3,840,-37.8538,145.0641,2625000,2248000,768176512,-377000,765551512
4,2,775,-37.8561,145.0934,1950000,2248000,715232128,298000,713282128
3,1,700,-37.8553,145.0711,2200000,2248000,652986432,48000,650786432
3,1,609,-37.8542,145.0733,1751000,2248000,581070464,497000,579319464
4,2,548,-37.8536,145.0547,1857000,2248000,535810272,391000,533953272
2,1,0,-37.8468,145.0515,720000,835500,98398008,115500,97678008
3,1,401,-37.8471,145.051,1500000,2248000,416673760,748000,415173760
4,3,603,-37.8521,145.0657,2725000,2248000,580876480,-477000,578151480
3,1,762,-37.8575,145.0554,2800000,2248000,701975552,-552000,699175552
3,1,685,-37.8538,145.0842,1665000,2248000,641139904,583000,639474904
2,1,0,-37.8555,145.0518,600000,835500,98399224,235500,97799224
3,1,615,-37.8578,145.0919,1420000,2248000,585824128,828000,584404128
5,2,654,-37.8515,145.0922,2410000,2248000,620970880,-162000,618560880
4,2,645,-37.8516,145.061,2100000,2248000,612472768,148000,610372768
4,2,1485,-37.8509,145.0856,2950000,2248000,1276338816,-702000,1273388816
5,2,1339,-37.8649,145.0547,3365000,2248000,1162304128,-1117000,1158939128
3,2,648,-37.8547,145.0771,1931000,2248000,613487808,317000,611556808
2,1,438,-37.8511,145.0428,1250000,2248000,444544000,998000,443294000
5,3,709,-37.8529,145.0806,2400000,2248000,666023616,-152000,663623616
3,1,696,-37.6972,144.9431,610000,2248000,649727872,1638000,649117872
3,1,640,-37.6979,144.9335,610000,2248000,605465280,1638000,604855280
3,1,766,-37.6988,144.9372,806500,2248000,705045312,1441500,704238812
4,2,683,-37.6964,144.9314,550000,2248000,642406144,1698000,641856144
3,1,700,-37.6988,144.9438,822000,2248000,652889728,1426000,652067728
3,2,1029,-37.7115,144.9147,980000,2248000,914474880,1268000,913494880
2,1,164,-37.7072,144.9252,430000,2248000,227912864,1818000,227482864
2,1,164,-37.7082,144.9178,540000,2248000,227908416,1708000,227368416
3,1,640,-37.6986,144.9243,737000,2248000,605459712,1511000,604722712
3,2,224,-37.702,144.9507,460000,2248000,278305344,1788000,277845344
3,2,136,-37.7112,144.9142,545000,2248000,208737680,1703000,208192680
3,1,734,-37.7007,144.9378,670000,2248000,679756416,1578000,679086416
4,1,606,-37.7104,144.9088,702000,2248000,579947584,1546000,579245584
2,1,705,-37.706,144.9245,730000,2248000,655463936,1518000,654733936
3,1,667,-37.7005,144.9185,711500,2248000,626794496,1536500,626082996
5,4,695,-37.7028,144.9377,810000,2248000,656447104,1438000,655637104
2,1,0,-37.711,144.9178,250000,835500,98299760,585500,98049760
3,1,325,-37.7001,144.9291,460000,2248000,356518720,1788000,356058720
3,1,780,-37.7,144.9427,793000,2248000,716113024,1455000,715320024
2,1,0,-37.7071,144.9176,340000,835500,98299184,495500,97959184
3,1,320,-37.6949,144.9122,447500,2248000,352556256,1800500,352108756
3,1,616,-37.7029,144.9053,588000,2248000,586481344,1660000,585893344
3,1,0,-37.7025,144.9504,420000,835500,99685032,415500,99265032
2,1,200,-37.7002,144.9428,410000,2248000,256373632,1838000,255963632
3,1,665,-37.6966,144.9331,525000,2248000,625222400,1723000,624697400
3,1,704,-37.7021,144.9136,703000,2248000,656032704,1545000,655329704
4,2,252,-37.7006,144.9299,608000,2248000,301786944,1640000,301178944
4,3,0,-37.7102,144.9112,607000,835500,104214560,228500,103607560
3,2,780,-37.6955,144.9389,765500,2248000,717703488,1482500,716937988
3,1,187,-37.7098,144.9163,470000,2248000,247450752,1778000,246980752
3,1,650,-37.7002,144.9408,580000,2248000,613372992,1668000,612792992
2,1,253,-37.7117,144.9135,620250,2248000,298242784,1627750,297622534
3,1,796,-37.6955,144.9253,710000,2248000,728746560,1538000,728036560
4,1,630,-37.7002,144.9232,630000,2248000,598922432,1618000,598292432
3,1,541,-37.7051,144.9069,600000,2248000,527210208,1648000,526610208
3,2,212,-37.7073,144.9277,550000,2248000,268808224,1698000,268258224
4,1,586,-37.6975,144.9065,600000,2248000,564138688,1648000,563538688
4,3,693,-37.7111,144.9275,1217500,2248000,651901760,1030500,650684260
3,1,599,-37.7009,144.9291,600000,2248000,573060672,1648000,572460672
3,2,585,-37.6977,144.9071,570000,2248000,563575872,1678000,563005872
3,1,597,-37.7097,144.9351,762700,2248000,571484800,1485300,570722100
2,1,176,-37.7081,144.912,465000,2248000,237388432,1783000,236923432
2,1,668,-37.7067,144.9331,741250,2248000,626228352,1506750,625487102
4,2,977,-37.7063,144.9273,1000000,2248000,874752704,1248000,873752704
4,2,602,-37.7005,144.9258,630000,2248000,578388992,1618000,577758992
3,1,705,-37.6967,144.9116,670000,2248000,656821120,1578000,656151120
2,1,172,-37.7074,144.9086,417000,2248000,234225056,1831000,233808056
3,1,258,-37.7047,144.9087,600000,2248000,303556704,1648000,302956704
3,2,215,-37.6952,144.9256,440000,2248000,271176416,1808000,270736416
3,1,657,-37.7019,144.9225,660000,2248000,618894080,1588000,618234080
2,1,155,-37.6972,144.9239,270000,2248000,220798176,1978000,220528176
4,2,768,-37.6979,144.9377,825000,2248000,709585664,1423000,708760664
4,2,624,-37.6969,144.9334,638000,2248000,595779776,1610000,595141776
3,2,608,-37.709,144.8925,631000,2248000,581745088,1617000,581114088
3,2,149,-37.7068,144.8963,532000,2248000,219000048,1716000,218468048
3,2,215,-37.709,144.8964,504000,2248000,271160032,1744000,270656032
3,2,178,-37.7087,144.8962,468000,2248000,241918832,1780000,241450832
4,2,0,-37.705,144.9004,802500,835500,102614032,33000,101811532
4,2,453,-37.7016,144.8974,709000,2248000,460617152,1539000,459908152
3,2,175,-37.7076,144.8961,485000,2248000,239547776,1763000,239062776
3,2,367,-37.704,144.8989,540000,2248000,391286432,1708000,390746432
3,2,158,-37.7091,144.8958,390000,2248000,226112672,1858000,225722672
4,2,719,-37.7062,144.8978,800000,2248000,670837440,1448000,670037440
4,2,453,-37.7016,144.8974,740000,2248000,460617152,1508000,459877152
3,1,597,-37.711,144.9478,605000,2248000,571492800,1643000,570887800
3,1,724,-37.7076,144.9481,685500,2248000,671860544,1562500,671175044
2,1,394,-37.7153,144.9507,610000,2248000,409698240,1638000,409088240
3,1,604,-37.7124,144.9514,630000,2248000,577027328,1618000,576397328
4,3,591,-37.7127,144.9489,870000,2248000,571304704,1378000,570434704
3,2,592,-37.7149,144.9473,810000,2248000,569134720,1438000,568324720
2,1,198,-37.7132,144.9488,487000,2248000,254798240,1761000,254311240
4,2,700,-37.7056,144.9384,700000,2248000,655846656,1548000,655146656
4,2,462,-37.7062,144.9387,600500,2248000,467755808,1647500,467155308
3,1,570,-37.7106,144.9491,730000,2248000,550155456,1518000,549425456
3,2,565,-37.7094,144.9377,800000,2248000,547790080,1448000,546990080
3,2,301,-37.715,144.9475,750000,2248000,339157888,1498000,338407888
3,1,568,-37.7077,144.9438,740000,2248000,548571328,1508000,547831328
3,1,574,-37.7157,144.9507,646000,2248000,553318272,1602000,552672272
3,2,230,-37.7073,144.9486,545000,2248000,283046464,1703000,282501464
4,1,700,-37.704,144.9399,777000,2248000,654254144,1471000,653477144
2,3,580,-37.7098,144.9424,722000,2248000,559874624,1526000,559152624
2,1,591,-37.7128,144.9471,545000,2248000,565384640,1703000,564839640
3,2,234,-37.707,144.9411,510000,2248000,286203040,1738000,285693040
3,1,593,-37.7133,144.947,631500,2248000,568331392,1616500,567699892
3,1,610,-37.7107,144.9419,550000,2248000,581763008,1698000,581213008
2,1,249,-37.714,144.939,330000,2248000,295097536,1918000,294767536
2,1,613,-37.7099,144.938,715888,2248000,582765184,1532112,582049296
2,1,137,-37.707,144.9413,468000,2248000,206584688,1780000,206116688
2,1,345,-37.7128,144.9496,515000,2248000,370972608,1733000,370457608
2,1,228,-37.9355,145.0008,895000,2248000,278565344,1353000,277670344
2,1,0,-37.9419,145.0019,587000,835500,98378656,248500,97791656
4,3,701,-37.9419,145.0152,2800000,2248000,658305280,-552000,655505280
4,3,928,-37.9389,145.0062,3250000,2248000,837697088,-1002000,834447088
4,2,688,-37.9319,145.0173,2140000,2248000,646438208,108000,644298208
4,2,607,-37.9324,145.0235,1600000,2248000,582427904,648000,580827904
3,1,289,-37.9338,145.0226,1003500,2248000,328152992,1244500,327149492
2,1,0,-37.939,145.0137,802000,835500,98385584,33500,97583584
3,1,593,-37.9399,145.0204,1560000,2248000,568403136,688000,566843136
2,1,90,-37.9389,145.0186,760000,2248000,169515456,1488000,168755456
2,1,0,-37.9373,145.0027,616000,835500,98378616,219500,97762616
4,1,723,-37.9437,145.0175,1680000,2248000,672506880,568000,670826880
3,2,373,-37.9395,145.0088,1120000,2248000,396123584,1128000,395003584
4,3,760,-37.9326,144.9997,3200000,2248000,704922240,-952000,701722240
4,3,398,-37.9381,145.0161,1250000,2248000,418844864,998000,417594864
4,3,615,-37.9429,145.0072,2000000,2248000,590334720,248000,588334720
5,2,700,-37.9419,145.0156,1805000,2248000,657288128,443000,655483128
4,1,1504,-37.944,145.0015,2600000,2248000,1289720576,-352000,1287120576
5,3,670,-37.9427,145.0085,3470000,2248000,635168128,-1222000,631698128
3,2,357,-37.9449,145.0144,1050000,2248000,383482848,1198000,382432848
3,1,195,-37.9396,145.0156,810000,2248000,253861280,1438000,253051280
3,2,413,-37.933,144.9975,1460000,2248000,427727776,788000,426267776
5,2,830,-37.9386,145.006,3075000,2248000,760020608,-827000,756945608
2,2,225,-37.9442,145.0018,875500,2248000,277789376,1372500,276913876
5,4,1000,-37.9332,145.0226,2600000,2248000,897567552,-352000,894967552
5,2,648,-37.946,145.0181,1705000,2248000,616194560,543000,614489560
4,2,611,-37.9446,145.0201,1515000,2248000,585588416,733000,584073416
5,3,694,-37.9372,145.0101,2980000,2248000,654135616,-732000,651155616
4,3,583,-37.9336,144.9999,2200000,2248000,565039616,48000,562839616
3,2,355,-37.9391,145.012,1100000,2248000,381900064,1148000,380800064
4,3,627,-37.9449,145.0068,3325000,2248000,599818368,-1077000,596493368
2,2,0,-37.9462,145.0212,450000,835500,99984312,385500,99534312
2,1,0,-37.9436,145.0027,500000,835500,98379360,335500,97879360
4,3,562,-37.9369,145.0163,1460000,2248000,548453824,788000,546993824
4,3,414,-37.9401,145.0083,1740000,2248000,431485056,508000,429745056
4,2,667,-37.9315,145.0109,1800000,2248000,629837952,448000,628037952
4,2,577,-37.9382,144.9997,2160000,2248000,558705024,88000,556545024
4,2,647,-37.9407,145.0104,2250000,2248000,614032768,-2000,611782768
4,2,714,-37.9446,145.0092,2130000,2248000,666982464,118000,664852464
2,1,0,-37.9367,145.0322,400000,835500,98396696,435500,97996696
3,2,393,-37.9431,145.0267,926000,2248000,411940960,1322000,411014960
3,1,583,-37.9428,145.0296,1070000,2248000,560506240,1178000,559436240
2,1,217,-37.9432,145.0348,801000,2248000,269893920,1447000,269092920
3,2,0,-37.9355,145.0276,1150000,835500,101353216,-314500,100203216
2,1,215,-37.933,145.0322,472000,2248000,268310496,1776000,267838496
3,2,586,-37.9431,145.0274,1300000,2248000,564469056,948000,563169056
4,2,0,-37.9405,145.0346,1200000,835500,102724312,-364500,101524312
4,2,317,-37.8344,145.0422,1650000,2248000,353241248,598000,351591248
4,2,336,-37.8183,145.0371,2670000,2248000,368251872,-422000,365581872
1,1,0,-37.8303,145.0341,348000,835500,97019152,487500,96671152
3,1,181,-37.8243,145.0328,1189000,2248000,242794144,1059000,241605144
2,2,85,-37.8154,145.0369,610000,2248000,167154000,1638000,166544000
1,1,0,-37.8299,145.0422,492000,835500,97024096,343500,96532096
2,1,0,-37.8249,145.0342,806000,835500,98384792,29500,97578792
3,2,460,-37.8155,145.019,2000000,2248000,464871232,248000,462871232
2,1,0,-37.8186,145.017,753000,835500,98373464,82500,97620464
1,1,0,-37.8177,145.0424,330000,835500,97022784,505500,96692784
3,1,218,-37.8214,145.0437,1420000,2248000,272041568,828000,270621568
2,1,0,-37.8216,145.0343,495000,835500,98384464,340500,97889464
1,1,0,-37.8294,145.0382,292000,835500,97021560,543500,96729560
2,1,1089,-37.8143,145.0322,580000,2248000,959017664,1668000,958437664
3,2,341,-37.8236,145.0425,1300000,2248000,370841120,948000,369541120
3,1,232,-37.8173,145.0252,1300000,2248000,283093856,948000,281793856
2,1,0,-37.8192,145.0385,440000,835500,98386768,395500,97946768
3,3,0,-37.8144,145.0153,1000000,835500,102924688,-164500,101924688
3,1,383,-37.8155,145.0385,1741000,2248000,402436992,507000,400695992
2,1,0,-37.8343,145.0364,655000,835500,98387256,180500,97732256
1,1,0,-37.8272,145.0343,488000,835500,97018912,347500,96530912
3,1,351,-37.8165,145.021,2065000,2248000,377136768,183000,375071768
1,1,0,-37.8208,145.0456,350000,835500,97025112,485500,96675112
3,1,342,-37.814,145.0212,1712000,2248000,370023904,536000,368311904
1,1,0,-37.8128,145.0171,480000,835500,97006640,355500,96526640
4,2,665,-37.814,145.0175,3225000,2248000,628247680,-977000,625022680
1,1,0,-37.8155,145.0161,400000,835500,97006336,435500,96606336
4,2,207,-37.8271,145.0243,1650000,2248000,266296496,598000,264646496
5,2,1236,-37.8257,145.0321,3950000,2248000,1080884864,-1702000,1076934864
2,1,1099,-37.8271,145.0347,587500,2248000,966923776,1660500,966336276
2,1,0,-37.8268,145.0344,560000,835500,98385136,275500,97825136
4,2,218,-37.8142,145.0252,1936000,2248000,274988832,312000,273052832
5,4,1275,-37.8291,145.0308,4250000,2248000,1114892672,-2002000,1110642672
3,1,0,-37.8153,145.021,630000,835500,99741744,205500,99111744
3,2,198,-37.8169,145.0234,1560000,2248000,257815840,688000,256255840
3,2,0,-37.8268,145.0344,840000,835500,101344624,-4500,100504624
3,3,88,-37.824,145.0427,1780000,2248000,172488944,468000,170708944
2,1,0,-37.8184,145.0163,815000,835500,98373008,20500,97558008
3,2,0,-37.8235,145.029,1975000,835500,101340912,-1139500,99365912
2,1,728,-37.8177,145.0424,657500,2248000,673726464,1590500,673068964
4,4,905,-37.8168,145.0321,5050000,2248000,821115200,-2802000,816065200
1,1,0,-37.8261,145.0269,445000,835500,97014224,390500,96569224
3,1,218,-37.8176,145.0204,1180000,2248000,272026752,1068000,270846752
2,1,0,-37.813,145.0207,470000,835500,98375088,365500,97905088
2,1,0,-37.8226,145.0368,485000,835500,98386128,350500,97901128
4,2,601,-37.839,145.0418,1800000,2248000,577686336,448000,575886336
3,1,304,-37.8253,145.0287,1855000,2248000,339998464,393000,338143464
2,1,0,-37.8183,145.0194,665000,835500,98374904,170500,97709904
3,1,199,-37.8172,145.0243,1551000,2248000,257013456,697000,255462456
2,1,859,-37.8183,145.0423,612500,2248000,777255680,1635500,776643180
3,2,249,-37.8169,145.021,2410000,2248000,298119584,-162000,295709584
2,1,0,-37.8142,145.0308,715000,835500,98381448,120500,97666448
2,2,191,-37.813,145.0167,1055000,2248000,250912960,1193000,249857960
4,2,410,-37.8246,145.026,1976000,2248000,426727904,272000,424751904
1,1,0,-37.8158,145.0342,499000,835500,97017504,336500,96518504
2,1,0,-37.8157,145.0273,495000,835500,98379464,340500,97884464
5,3,827,-37.8144,145.0279,3750000,2248000,759241984,-1502000,755491984
3,2,164,-37.8159,145.0219,1400000,2248000,230944640,848000,229544640
1,1,0,-37.8222,145.0329,370000,835500,97017456,465500,96647456
2,2,0,-37.8213,145.0224,627500,835500,99970392,208000,99342892
2,1,589,-37.7501,145.0505,815000,2248000,563872000,1433000,563057000
2,2,201,-37.7426,145.0556,565000,2248000,258831632,1683000,258266632
3,2,807,-37.7453,145.0559,994000,2248000,739119424,1254000,738125424
3,1,592,-37.7477,145.0481,785000,2248000,567607296,1463000,566822296
3,2,215,-37.7424,145.0519,620000,2248000,271259680,1628000,270639680
3,2,250,-37.7449,145.0523,706750,2248000,298920704,1541250,298213954
2,1,428,-37.7418,145.0513,584000,2248000,436633440,1664000,436049440
3,2,585,-37.7358,145.0546,909000,2248000,563671168,1339000,562762168
4,2,724,-37.7404,145.0582,1086000,2248000,674891648,1162000,673805648
2,1,605,-37.7365,145.0545,680000,2248000,576517632,1568000,575837632
2,1,620,-37.7377,145.0541,650000,2248000,588371968,1598000,587721968
5,2,596,-37.7487,145.0522,890000,2248000,575096896,1358000,574206896
3,1,582,-37.7422,145.05,650000,2248000,559704896,1598000,559054896
2,1,166,-37.7416,145.0567,605000,2248000,229578432,1643000,228973432
8,4,638,-37.7426,145.048,770000,2248000,615571264,1478000,614801264
3,1,800,-37.7406,145.0483,950000,2248000,731988800,1298000,731038800
4,1,722,-37.7477,145.0565,856000,2248000,671717504,1392000,670861504
3,2,251,-37.7358,145.0559,600000,2248000,299712128,1648000,299112128
3,1,748,-37.7416,145.0481,915000,2248000,690893120,1333000,689978120
2,1,127,-37.747,145.0575,400000,2248000,198757888,1848000,198357888
3,1,420,-37.7363,145.0506,550000,2248000,431676160,1698000,431126160
2,1,586,-37.7435,145.0486,590000,2248000,561499200,1658000,560909200
2,1,932,-37.7333,145.0588,920000,2248000,834947584,1328000,834027584
2,1,508,-37.7428,145.0557,460000,2248000,499860160,1788000,499400160
4,2,592,-37.7478,145.0477,1000500,2248000,570566592,1247500,569566092
3,1,596,-37.7432,145.0479,631000,2248000,570767936,1617000,570136936
3,1,624,-37.7456,145.0397,691000,2248000,592891520,1557000,592200520
3,1,523,-37.7369,145.0376,560000,2248000,513069024,1688000,512509024
2,1,100,-37.7383,145.036,370000,2248000,177405584,1878000,177035584
3,1,390,-37.7369,145.0422,532000,2248000,407962144,1716000,407430144
2,1,331,-37.7441,145.0379,515500,2248000,359966496,1732500,359450996
3,1,633,-37.746,145.0422,800000,2248000,600005824,1448000,599205824
2,1,668,-37.7389,145.0393,620000,2248000,626297344,1628000,625677344
2,1,89,-37.7444,145.047,360000,2248000,168719792,1888000,168359792
2,1,368,-37.7341,145.0434,440500,2248000,389209728,1807500,388769228
4,1,632,-37.7466,145.0428,758000,2248000,600582208,1490000,599824208
3,1,338,-37.739,145.0481,480000,2248000,366870432,1768000,366390432
4,2,521,-37.738,145.0374,715000,2248000,514447936,1533000,513732936
3,1,616,-37.747,145.0389,646250,2248000,586568768,1601750,585922518
3,1,368,-37.7344,145.044,1375000,2248000,390576384,873000,389201384
3,1,593,-37.7386,145.0387,722000,2248000,568390784,1526000,567668784
2,1,632,-37.7443,145.0462,725000,2248000,597851520,1523000,597126520
3,1,413,-37.7399,145.0369,465000,2248000,426136064,1783000,425671064
2,1,732,-37.8931,145.0791,1550000,2248000,676919104,698000,675369104
2,1,0,-37.8967,145.0858,516000,835500,98424992,319500,97908992
3,1,705,-37.8994,145.0816,1340000,2248000,656949568,908000,655609568
3,1,715,-37.9072,145.0762,1316000,2248000,664850176,932000,663534176
3,2,206,-37.8966,145.0863,828000,2248000,264186304,1420000,263358304
3,1,562,-37.9022,145.0811,1055000,2248000,543936832,1193000,542881832
2,1,101,-37.8988,145.0781,623000,2248000,178240672,1625000,177617672
4,2,847,-37.8927,145.0781,2120000,2248000,772128512,128000,770008512
4,2,547,-37.9002,145.0768,1745000,2248000,535039040,503000,533294040
4,2,545,-37.9002,145.0773,1700000,2248000,533458720,548000,531758720
2,1,0,-37.9008,145.0859,420000,835500,98425536,415500,98005536
4,1,696,-37.8991,145.0804,1337000,2248000,651202304,911000,649865304
2,1,0,-37.8942,145.0867,455000,835500,98425248,380500,97970248
2,1,100,-37.8945,145.0876,400000,2248000,177455712,1848000,177055712
3,1,730,-37.9034,145.0796,1210000,2248000,676706304,1038000,675496304
4,2,678,-37.898,145.0815,1167500,2248000,638570752,1080500,637403252
3,2,360,-37.8937,145.0779,900000,2248000,385886816,1348000,384986816
2,1,575,-37.9084,145.0775,677500,2248000,552843072,1570500,552165572
4,2,925,-37.7652,145.041,2265000,2248000,833734016,-17000,831469016
3,3,626,-37.76,145.0326,981000,2248000,597656000,1267000,596675000
4,2,1252,-37.7727,145.0484,2400000,2248000,1092167168,-152000,1089767168
3,2,249,-37.766,145.0345,890000,2248000,298121888,1358000,297231888
2,1,648,-37.7702,145.0493,739000,2248000,610501248,1509000,609762248
3,2,399,-37.7551,145.05,785000,2248000,416674976,1463000,415889976
3,1,537,-37.7773,145.0379,1155000,2248000,524138176,1093000,522983176
2,1,557,-37.7568,145.0355,1020000,2248000,538574016,1228000,537554016
3,1,630,-37.7635,145.039,1465000,2248000,597635008,783000,596170008
3,2,0,-37.765,145.0422,855000,835500,101342152,-19500,100487152
1,1,845,-37.7591,145.0501,413000,2248000,764823168,1835000,764410168
3,1,687,-37.7634,145.0361,1220000,2248000,642680192,1028000,641460192
3,2,608,-37.7702,145.0398,1605000,2248000,581842944,643000,580237944
2,1,721,-37.7634,145.0406,587000,2248000,668186944,1661000,667599944
3,1,691,-37.7674,145.0392,1535000,2248000,645843776,713000,644308776
4,2,694,-37.7565,145.0506,1470000,2248000,651179840,778000,649709840
3,1,645,-37.7634,145.0439,1486000,2248000,609492544,762000,608006544
5,2,689,-37.7591,145.04,1730000,2248000,648588352,518000,646858352
3,2,684,-37.7659,145.0392,1850000,2248000,641904768,398000,640054768
5,3,1006,-37.7765,145.0427,2600000,2248000,900710016,-352000,898110016
2,1,71,-37.7634,145.0406,500000,2248000,154492720,1748000,153992720
3,1,597,-37.7645,145.0314,1102000,2248000,571550592,1146000,570448592
3,2,834,-37.7587,145.0426,1275000,2248000,760450816,973000,759175816
2,2,124,-37.7618,145.0287,785000,2248000,197964304,1463000,197179304
3,2,721,-37.758,145.0408,1223500,2248000,671145920,1024500,669922420
4,2,631,-37.7771,145.0448,1720000,2248000,601389952,528000,599669952
3,1,572,-37.7709,145.0425,1225000,2248000,551800640,1023000,550575640
4,1,605,-37.7707,145.0467,1460000,2248000,579249280,788000,577789280
1,1,0,-37.7753,145.0419,421000,835500,97017488,414500,96596488
4,3,608,-37.7705,145.0396,2090000,2248000,584802304,158000,582712304
3,2,189,-37.7661,145.0354,700000,2248000,250704592,1548000,250004592
4,3,719,-37.7815,145.0403,2595000,2248000,672527232,-347000,669932232
2,1,134,-37.7582,145.034,710000,2248000,204276864,1538000,203566864
3,2,0,-37.7694,145.0406,650000,835500,101341688,185500,100691688
3,1,597,-37.7392,144.8241,515000,2248000,571419968,1733000,570904968
3,2,530,-37.7375,144.8282,582000,2248000,520065568,1666000,519483568
3,2,570,-37.7367,144.8246,545000,2248000,551675200,1703000,551130200
4,2,649,-37.7382,144.8292,751000,2248000,615478016,1497000,614727016
4,1,574,-37.7336,144.8226,500000,2248000,554607680,1748000,554107680
4,2,612,-37.7378,144.8264,560000,2248000,586235264,1688000,585675264
3,2,683,-37.7402,144.8591,703000,2248000,641000640,1545000,640297640
3,1,538,-37.7441,144.8503,650000,2248000,524809056,1598000,524159056
3,2,331,-37.7325,144.8621,770000,2248000,362816384,1478000,362046384
4,2,289,-37.7506,144.8689,900000,2248000,330996352,1348000,330096352
3,2,288,-37.7514,144.8731,700000,2248000,328842528,1548000,328142528
4,2,540,-37.7482,144.877,816000,2248000,529366016,1432000,528550016
4,1,622,-37.7425,144.8683,845000,2248000,592571200,1403000,591726200
3,2,672,-37.7465,144.876,772000,2248000,632318528,1476000,631546528
3,2,3977,-37.747,144.8663,650000,2248000,3244249856,1598000,3243599856
3,2,532,-37.7295,144.8644,757000,2248000,521667488,1491000,520910488
3,2,568,-37.7469,144.8526,690000,2248000,550113088,1558000,549423088
3,1,412,-37.7459,144.8643,583000,2248000,425240224,1665000,424657224
3,1,584,-37.7435,144.8798,880000,2248000,561180928,1368000,560300928
3,2,112,-37.7434,144.881,580000,2248000,189753840,1668000,189173840
4,3,322,-37.7293,144.8659,886000,2248000,358665120,1362000,357779120
4,2,745,-37.7479,144.8805,920000,2248000,691379456,1328000,690459456
3,3,605,-37.7459,144.8788,976000,2248000,580963392,1272000,579987392
4,2,613,-37.7453,144.8721,1420000,2248000,587054528,828000,585634528
3,1,713,-37.7301,144.8671,900000,2248000,663120064,1348000,662220064
3,1,352,-37.7459,144.8673,560000,2248000,377824160,1688000,377264160
4,2,776,-37.7502,144.8745,1010000,2248000,715875328,1238000,714865328
4,2,708,-37.7452,144.8652,835000,2248000,662128576,1413000,661293576
3,2,440,-37.7517,144.8776,705000,2248000,448970752,1543000,448265752
3,2,224,-37.749,144.8599,680000,2248000,278255008,1568000,277575008
3,1,606,-37.7311,144.8663,785000,2248000,578557760,1463000,577772760
3,2,716,-37.734,144.8593,695000,2248000,667079872,1553000,666384872
2,1,0,-37.7346,144.8646,502000,835500,98269792,333500,97767792
4,2,546,-37.7428,144.8536,770000,2248000,534092800,1478000,533322800
3,1,542,-37.7408,144.8553,570000,2248000,527972928,1678000,527402928
4,2,686,-37.7394,144.8628,830000,2248000,644739904,1418000,643909904
3,1,565,-37.7498,144.8585,600000,2248000,546152896,1648000,545552896
3,2,630,-37.7378,144.8705,825000,2248000,599121536,1423000,598296536
4,2,547,-37.7381,144.8554,735000,2248000,534883744,1513000,534148744
3,2,928,-37.7362,144.8643,875000,2248000,834626560,1373000,833751560
3,1,554,-37.7303,144.8636,601200,2248000,537460416,1646800,536859216
3,1,558,-37.7305,144.8646,680000,2248000,540622272,1568000,539942272
3,1,616,-37.7449,144.8533,705000,2248000,586454272,1543000,585749272
3,2,320,-37.7415,144.8668,710000,2248000,354127040,1538000,353417040
4,2,544,-37.7479,144.8763,732000,2248000,532526752,1516000,531794752
3,2,598,-37.7487,144.8526,715000,2248000,573822272,1533000,573107272
3,1,166,-37.7929,144.9197,852000,2248000,230866336,1396000,230014336
3,1,188,-37.7953,144.9275,1037000,2248000,248258000,1211000,247221000
3,1,199,-37.7957,144.932,1470000,2248000,256954112,778000,255484112
2,1,0,-37.7974,144.9261,492500,835500,98315024,343000,97822524
2,1,0,-37.794,144.923,420000,835500,98312728,415500,97892728
2,1,0,-37.7899,144.9231,420000,835500,98312296,415500,97892296
3,1,284,-37.7938,144.9228,1271000,2248000,324123648,977000,322852648
3,1,234,-37.7923,144.9332,1010000,2248000,284614912,1238000,283604912
2,1,325,-37.7976,144.9213,750000,2248000,355159200,1498000,354409200
2,2,138,-37.799,144.9276,905000,2248000,208970608,1343000,208065608
2,1,174,-37.7959,144.9343,960000,2248000,235831888,1288000,234871888
2,1,163,-37.7929,144.9287,1031000,2248000,227134768,1217000,226103768
3,1,211,-37.7891,144.926,870000,2248000,266433216,1378000,265563216
3,1,239,-37.7923,144.9324,1165000,2248000,288565920,1083000,287400920
5,2,566,-37.7893,144.933,1710000,2248000,551319296,538000,549609296
3,1,275,-37.7954,144.9274,1455000,2248000,317013984,793000,315558984
1,1,0,-37.7961,144.9261,365000,835500,96948656,470500,96583656
2,2,3448,-37.7976,144.9285,442000,2248000,2824859904,1806000,2824417904
2,1,158,-37.7902,144.9319,765000,2248000,223184960,1483000,222419960
2,1,3957,-37.7974,144.9261,515000,2248000,3225527296,1733000,3225012296
1,1,0,-37.7961,144.9261,370000,835500,96948656,465500,96578656
2,2,169,-37.7922,144.9316,1234500,2248000,233471552,1013500,232237052
2,1,1111,-37.7896,144.9321,666000,2248000,976339840,1582000,975673840
2,1,211,-37.7925,144.9264,825000,2248000,265067696,1423000,264242696
2,1,132,-37.7989,144.9275,812000,2248000,202635520,1436000,201823520
5,2,566,-37.7893,144.933,1900000,2248000,551319296,348000,549419296
1,1,0,-37.7913,144.9323,445000,835500,96951912,390500,96506912
2,2,94,-37.7934,144.9166,732000,2248000,174190048,1516000,173458048
3,2,250,-37.792,144.9324,1260000,2248000,298852448,988000,297592448
3,2,211,-37.7926,144.9197,1000000,2248000,268023040,1248000,267023040
2,1,197,-37.7918,144.9264,1155000,2248000,254003408,1093000,252848408
3,2,1181,-37.7982,144.9202,790000,2248000,1034613824,1458000,1033823824
2,2,324,-37.7903,144.9345,700000,2248000,355969440,1548000,355269440
3,1,312,-37.793,144.934,1230000,2248000,346258784,1018000,345028784
2,1,0,-37.7948,144.9314,460000,835500,98317984,375500,97857984
2,1,0,-37.7899,144.9231,395000,835500,98312296,440500,97917296
2,1,169,-37.7925,144.9315,850000,2248000,231878256,1398000,231028256
2,1,97,-37.7921,144.9234,868000,2248000,174971696,1380000,174103696
2,1,0,-37.7937,144.9295,773000,835500,98316680,62500,97543680
2,2,2136,-37.7956,144.935,631090,2248000,1787991808,1616910,1787360718
2,1,0,-37.7897,144.9228,410000,835500,98312088,425500,97902088
2,1,0,-37.7966,144.9254,425000,835500,98314504,410500,97889504
2,1,745,-37.8024,145.0346,610000,2248000,687154944,1638000,686544944
3,2,0,-37.8064,145.0182,882000,835500,101332256,-46500,100450256
4,3,992,-37.8046,145.0603,3550000,2248000,888293888,-1302000,884743888
2,1,405,-37.8012,145.0361,1326000,2248000,418454208,922000,417128208
4,2,400,-37.8147,145.0438,1950000,2248000,418834688,298000,416884688
4,2,603,-37.8095,145.0391,2550000,2248000,579261824,-302000,576711824
3,2,392,-37.8081,145.0263,1878000,2248000,411134560,370000,409256560
4,3,277,-37.8007,145.0374,1910000,2248000,323215648,338000,321305648
3,1,304,-37.8023,145.0404,1410000,2248000,340003008,838000,338593008
3,1,782,-37.8107,145.0219,2310000,2248000,717755328,-62000,715445328
4,2,364,-37.8125,145.043,2315000,2248000,390383200,-67000,388068200
3,2,848,-37.796,145.0324,800000,2248000,771513152,1448000,770713152
5,4,957,-37.8112,145.057,4850000,2248000,863591552,-2602000,858741552
6,6,1334,-37.8029,145.0267,6500000,2248000,1166067456,-4252000,1159567456
2,1,0,-37.8071,145.0243,580000,835500,98376608,255500,97796608
3,2,591,-37.812,145.0268,1905000,2248000,568404736,343000,566499736
2,1,0,-37.7997,145.0304,478000,835500,98379480,357500,97901480
2,1,0,-37.8108,145.0545,672000,835500,98395640,163500,97723640
4,3,712,-37.8034,145.0527,2286000,2248000,667005376,-38000,664719376
3,2,397,-37.8013,145.0335,1575000,2248000,415089696,673000,413514696
2,1,0,-37.805,145.0294,590000,835500,98379504,245500,97789504
4,2,861,-37.8047,145.0534,2350000,2248000,783167168,-102000,780817168
4,2,687,-37.8096,145.0529,1312000,2248000,645655424,936000,644343424
2,2,89,-37.8148,145.0571,890000,2248000,170327552,1358000,169437552
2,1,424,-37.7995,145.0418,1331000,2248000,433473152,917000,432142152
4,2,586,-37.7933,145.0343,1800000,2248000,565821888,448000,564021888
3,2,288,-37.7997,145.046,1476000,2248000,328954592,772000,327478592
4,2,660,-37.8124,145.0361,2590000,2248000,624307328,-342000,621717328
4,2,717,-37.8083,145.0418,2625000,2248000,669357376,-377000,666732376
4,1,650,-37.8098,145.022,2265000,2248000,614802112,-17000,612537112
5,2,531,-37.813,145.0411,1975000,2248000,523728160,273000,521753160
5,4,597,-37.7937,145.0353,2550000,2248000,579068544,-302000,576518544
3,2,205,-37.7993,145.0267,1330000,2248000,263347888,918000,262017888
3,2,247,-37.8053,145.0327,1450000,2248000,296544832,798000,295094832
3,2,1353,-37.8006,145.0218,3650000,2248000,1170608000,-1402000,1166958000
2,1,0,-37.7925,145.0263,551000,835500,98376128,284500,97825128
4,4,737,-37.8042,145.0291,2460000,2248000,688341696,-212000,685881696
4,2,690,-37.8037,145.0308,2850000,2248000,648012032,-602000,645162032
5,2,534,-37.8044,145.0386,2425000,2248000,526096544,-177000,523671544
2,1,745,-37.8024,145.0346,610000,2248000,687154944,1638000,686544944
3,2,140,-37.8063,145.0179,955000,2248000,211973872,1293000,211018872
2,1,124,-37.7938,145.0321,707500,2248000,196376896,1540500,195669396
3,1,904,-37.801,145.0297,732000,2248000,814175552,1516000,813443552
2,1,1065,-37.7944,145.0339,2875000,2248000,940049280,-627000,937174280
3,1,857,-37.7981,145.0423,1500000,2248000,777038848,748000,775538848
4,3,641,-37.7982,145.0281,1750000,2248000,610878400,498000,609128400
3,1,0,-37.8087,145.0452,1100000,835500,99755864,-264500,98655864
3,1,298,-37.8021,145.0391,1440000,2248000,335260384,808000,333820384
4,3,670,-37.8042,145.0279,2560000,2248000,633797632,-312000,631237632
5,2,674,-37.8064,145.0608,2600000,2248000,636752256,-352000,634152256
5,5,480,-37.8117,145.0449,3280000,2248000,488204928,-1032000,484924928
3,1,0,-37.7978,145.0333,620000,835500,99747248,215500,99127248
4,3,700,-37.8033,145.0526,2600000,2248000,657521664,-352000,654921664
5,2,920,-37.8017,145.0419,2800000,2248000,831153600,-552000,828353600
3,2,275,-37.8052,145.0489,1420000,2248000,318683168,828000,317263168
3,2,336,-37.8074,145.0318,1800000,2248000,366881120,448000,365081120
1,1,0,-37.7999,145.0544,395000,835500,97028072,440500,96633072
4,3,741,-37.8043,145.0291,2250000,2248000,689909568,-2000,687659568
5,2,711,-37.7923,145.0528,1950000,2248000,665986688,298000,664036688
2,1,0,-37.7969,145.0511,605000,835500,98391904,230500,97786904
3,1,672,-37.789,145.0616,1920000,2248000,630844480,328000,628924480
3,1,702,-37.7922,145.0518,1615000,2248000,654547840,633000,652932840
4,4,948,-37.7881,145.0631,2081000,2248000,855113792,167000,853032792
4,2,458,-37.7981,145.0472,1315000,2248000,464672224,933000,463357224
3,2,611,-37.7997,145.058,1750000,2248000,584228480,498000,582478480
5,3,695,-37.7904,145.0548,2100000,2248000,654936256,148000,652836256
6,3,730,-37.7917,145.0509,1300000,2248000,683960640,948000,682660640
4,2,458,-37.7981,145.0472,1315000,2248000,464672224,933000,463357224
3,2,248,-37.7923,145.0595,1620000,2248000,297350048,628000,295730048
3,2,165,-37.7773,144.8725,615000,2248000,231638448,1633000,231023448
3,1,576,-37.7808,144.8678,715000,2248000,554855424,1533000,554140424
4,2,308,-37.7833,144.8817,826000,2248000,346023744,1422000,345197744
2,1,1972,-37.7863,144.8769,275000,2248000,1656752768,1973000,1656477768
2,1,163,-37.789,144.8813,711000,2248000,227105136,1537000,226394136
3,2,156,-37.7898,144.8722,695000,2248000,224527024,1553000,223832024
3,1,306,-37.7838,144.8724,490000,2248000,341477984,1758000,340987984
2,1,144,-37.7895,144.8667,502000,2248000,212080544,1746000,211578544
3,2,239,-37.7882,144.8784,721000,2248000,290125472,1527000,289404472
3,1,584,-37.7885,144.8771,840000,2248000,561184512,1408000,560344512
2,1,0,-37.7776,144.8723,335000,835500,98279584,500500,97944584
3,1,300,-37.7896,144.8752,832000,2248000,336738624,1416000,335906624
2,1,270,-37.7871,144.8791,646000,2248000,311665568,1602000,311019568
3,1,285,-37.7813,144.8678,673000,2248000,324878592,1575000,324205592
3,1,214,-37.7798,144.8661,695000,2248000,268766144,1553000,268071144
2,1,0,-37.7795,144.8729,349000,835500,98280184,486500,97931184
3,1,210,-37.7869,144.8749,555000,2248000,265611216,1693000,265056216
2,1,15100,-37.7795,144.8729,352500,2248000,12031792128,1895500,12031439628
5,3,527,-37.7746,144.8727,1350000,2248000,522052064,898000,520702064
2,1,118,-37.787,144.8748,510000,2248000,191537472,1738000,191027472
3,1,269,-37.7844,144.8665,490000,2248000,312233408,1758000,311743408
4,1,595,-37.7817,144.868,675000,2248000,571237504,1573000,570562504
3,1,381,-37.7874,144.8763,865000,2248000,400753248,1383000,399888248
2,2,145,-37.7801,144.869,600000,2248000,214464432,1648000,213864432
4,1,333,-37.7893,144.8818,773000,2248000,364188736,1475000,363415736
3,2,231,-37.8607,145.0373,2050000,2248000,283909408,198000,281859408
4,2,502,-37.8515,145.0324,3460000,2248000,499442464,-1212000,495982464
4,2,586,-37.866,145.039,2400000,2248000,565833344,-152000,563433344
3,2,396,-37.8562,145.0373,2025000,2248000,414308160,223000,412283160
2,1,0,-37.8515,145.0372,611000,835500,98389760,224500,97778760
4,3,587,-37.8613,145.0393,3800000,2248000,568216576,-1552000,564416576
3,2,227,-37.8577,145.0406,1390000,2248000,280749888,858000,279359888
3,1,696,-37.8462,145.0386,2415000,2248000,649804160,-167000,647389160
2,1,0,-37.8633,145.0338,566000,835500,98389048,269500,97823048
3,1,313,-37.8511,145.0317,1437000,2248000,347116096,811000,345679096
2,1,0,-37.8693,145.0348,500000,835500,98390376,335500,97890376
5,3,807,-37.8684,145.035,3400000,2248000,743446592,-1152000,740046592
3,2,471,-37.851,145.0316,2355000,2248000,473576480,-107000,471221480
5,3,580,-37.8653,145.0304,4240000,2248000,564045696,-1992000,559805696
2,1,254,-37.8674,145.0355,1326000,2248000,299126464,922000,297800464
4,4,716,-37.8469,145.0377,4525000,2248000,671755712,-2277000,667230712
4,2,300,-37.8638,145.0298,1965000,2248000,339802016,283000,337837016
4,3,585,-37.868,145.038,3470000,2248000,566635904,-1222000,563165904
2,1,0,-37.8597,145.0322,740000,835500,98387656,95500,97647656
5,3,501,-37.8631,145.0353,2325000,2248000,501614816,-77000,499289816
3,2,246,-37.871,145.0364,1970000,2248000,295764544,278000,293794544
2,1,232,-37.8686,145.038,1475000,2248000,281741568,773000,280266568
2,1,0,-37.854,145.041,584000,835500,98392400,251500,97808400
3,1,322,-37.8726,145.0396,1490000,2248000,354236128,758000,352746128
3,2,337,-37.8833,145.0697,1210000,2248000,367703680,1038000,366493680
4,2,0,-37.8755,145.0523,2355000,835500,102727568,-1519500,100372568
2,1,310,-37.8717,145.0399,1036000,2248000,343386432,1212000,342350432
3,3,376,-37.8727,145.0458,2273000,2248000,400102656,-25000,397829656
5,2,567,-37.8786,145.0495,2350000,2248000,552191808,-102000,549841808
4,3,567,-37.8742,145.0614,2200000,2248000,552425664,48000,550225664
2,1,196,-37.8796,145.0876,790000,2248000,253322672,1458000,252532672
4,2,797,-37.8783,145.0869,1185000,2248000,732617344,1063000,731432344
3,2,769,-37.8799,145.0552,1837000,2248000,709103488,411000,707266488
3,2,216,-37.866,145.0549,1253000,2248000,272066368,995000,270813368
3,2,0,-37.8782,145.0649,922000,835500,101369424,-86500,100447424
5,2,837,-37.8756,145.0561,4802500,2248000,765576192,-2554500,760773692
1,1,0,-37.8769,145.0471,350000,835500,97032640,485500,96682640
3,2,691,-37.8734,145.0887,1555000,2248000,647480000,693000,645925000
4,3,412,-37.8707,145.0482,2123000,2248000,429920832,125000,427797832
4,3,365,-37.8818,145.0548,1700000,2248000,392782176,548000,391082176
2,1,604,-37.8835,145.0886,1150000,2248000,575765568,1098000,574615568
4,2,526,-37.8771,145.0505,2001000,2248000,518423808,247000,516422808
3,2,700,-37.8807,145.0547,1915000,2248000,654572672,333000,652657672
3,3,0,-37.8812,145.057,1135000,835500,102958192,-299500,101823192
4,2,310,-37.8822,145.0837,1240000,2248000,347740320,1008000,346500320
3,2,181,-37.8823,145.0839,1120000,2248000,244425648,1128000,243305648
3,1,888,-37.8799,145.0738,1500000,2248000,801567232,748000,800067232
3,1,170,-37.8689,145.0504,707500,2248000,234116928,1540500,233409428
2,1,0,-37.865,145.0506,835000,835500,98399592,500,97564592
3,2,400,-37.8718,145.0404,1870000,2248000,417473120,378000,415603120
4,2,504,-37.8834,145.0635,1580000,2248000,501045984,668000,499465984
2,2,0,-37.8823,145.0729,820000,835500,100008640,15500,99188640
2,1,0,-37.8811,145.0524,480000,835500,98402592,355500,97922592
3,2,234,-37.8695,145.05,1680000,2248000,286289152,568000,284609152
1,1,0,-37.8764,145.0463,300000,835500,97032080,535500,96732080
3,1,645,-37.875,145.0861,1100000,2248000,609531584,1148000,608431584
1,1,0,-37.8728,145.0417,373000,835500,97028816,462500,96655816
4,3,427,-37.8704,145.0503,2560000,2248000,441776576,-312000,439216576
3,2,310,-37.8733,145.0883,960000,2248000,346375904,1288000,345415904
1,1,0,-37.8704,145.0495,315000,835500,97033344,520500,96718344
3,1,333,-37.8722,145.067,1297000,2248000,362946240,951000,361649240
3,2,0,-37.8689,145.06,1015000,835500,101365312,-179500,100350312
2,1,0,-37.8801,145.0874,523000,835500,98424016,312500,97901016
3,2,606,-37.8831,145.0879,1335000,2248000,580305216,913000,578970216
2,1,0,-37.8804,145.0501,425000,835500,98401096,410500,97976096
3,2,375,-37.8777,145.0608,1670000,2248000,397728864,578000,396058864
4,3,222,-37.878,145.0666,1350000,2248000,279776288,898000,278426288
3,1,764,-37.8814,145.0583,1650000,2248000,703560768,598000,701910768
3,1,288,-37.8752,145.0817,950000,2248000,327392192,1298000,326442192
3,1,615,-37.8846,145.0861,1782500,2248000,585823680,465500,584041180
2,2,0,-37.8828,145.0528,650000,835500,99996320,185500,99346320
3,1,597,-37.763,144.8877,975000,2248000,571461888,1273000,570486888
3,2,77,-37.7746,144.8798,560000,2248000,162096336,1688000,161536336
2,1,0,-37.7716,144.882,355000,835500,98284856,480500,97929856
3,2,77,-37.7743,144.8797,550000,2248000,162096208,1698000,161546208
2,1,5661,-37.773,144.8806,420000,2248000,4572165632,1828000,4571745632
2,1,904,-37.7679,144.8935,399000,2248000,812721600,1849000,812322600
3,1,762,-37.7707,144.8924,1105000,2248000,701865024,1143000,700760024
3,1,250,-37.7861,144.8897,730000,2248000,297232192,1518000,296502192
3,2,202,-37.768,144.8894,662500,2248000,260888816,1585500,260226316
2,1,53,-37.7736,144.8798,410000,2248000,140169552,1838000,139759552
3,1,689,-37.7823,144.887,920000,2248000,644171264,1328000,643251264
3,2,645,-37.7662,144.8971,1320000,2248000,610995776,928000,609675776
5,3,446,-37.7712,144.8763,1150000,2248000,458039744,1098000,456889744
3,2,222,-37.7697,144.878,847000,2248000,276688000,1401000,275841000
2,1,3967,-37.7706,144.8805,400000,2248000,3233399040,1848000,3232999040
3,2,1396,-37.7833,144.888,1072000,2248000,1204506496,1176000,1203434496
2,2,176,-37.7693,144.8905,510000,2248000,238975680,1738000,238465680
3,2,151,-37.7855,144.8958,865000,2248000,220589568,1383000,219724568
2,1,98,-37.7677,144.8925,570000,2248000,175740128,1678000,175170128
4,3,865,-37.7682,144.8971,1900000,2248000,787821120,348000,785921120
2,1,83,-37.7732,144.8927,429000,2248000,163886400,1819000,163457400
3,2,4977,-37.7737,144.8816,456000,2248000,4034561536,1792000,4034105536
2,2,3014,-37.7853,144.8944,566000,2248000,2481848064,1682000,2481282064
2,1,85,-37.7732,144.8927,408000,2248000,165467008,1840000,165059008
2,2,0,-37.7853,144.8999,470000,835500,99890760,365500,99420760
3,3,173,-37.773,144.8947,780000,2248000,239567264,1468000,238787264
2,1,54,-37.774,144.8797,440000,2248000,140959840,1808000,140519840
4,2,452,-37.774,144.877,1048700,2248000,459822784,1199300,458774084
2,1,54,-37.774,144.8797,400000,2248000,140959840,1848000,140559840
4,3,613,-37.7799,144.8879,1215000,2248000,588661504,1033000,587446504
4,3,688,-37.7713,144.8937,1180000,2248000,647936512,1068000,646756512
4,3,325,-37.7822,144.8922,1117000,2248000,361058432,1131000,359941432
2,1,0,-37.7678,144.8899,420000,835500,98289264,415500,97869264
4,2,215,-37.7817,144.8916,770000,2248000,272531872,1478000,271761872
5,2,694,-37.7819,144.8901,1151000,2248000,652450304,1097000,651299304
3,1,678,-37.769,144.8935,907000,2248000,635480320,1341000,634573320
2,2,3014,-37.7853,144.8944,570000,2248000,2481848064,1678000,2481278064
3,2,203,-37.7853,144.8972,820000,2248000,261685952,1428000,260865952
3,1,695,-37.7825,144.886,940000,2248000,648912448,1308000,647972448
4,2,573,-37.7844,144.8876,1030000,2248000,555456768,1218000,554426768
4,3,270,-37.7847,144.8962,1230000,2248000,317594752,1018000,316364752
3,2,211,-37.7848,144.8969,884500,2248000,268008112,1363500,267123612
3,1,578,-37.7837,144.8887,820000,2248000,556449280,1428000,555629280
2,2,0,-37.8095,144.9691,780000,835500,99936192,55500,99156192
2,1,0,-37.808,144.9617,535000,835500,98338176,300500,97803176
2,1,0,-37.8091,144.9609,450000,835500,98337816,385500,97887816
2,1,0,-37.8138,144.9548,360000,835500,98334624,475500,97974624
2,1,0,-37.8106,144.9646,665000,835500,98340272,170500,97675272
1,1,0,-37.8127,144.9627,386000,835500,96973136,449500,96587136
1,1,0,-37.8157,144.9727,659000,835500,96979648,176500,96320648
2,1,0,-37.8188,144.9544,545000,835500,98334960,290500,97789960
1,1,0,-37.8178,144.9607,450000,835500,96972504,385500,96522504
1,1,0,-37.8111,144.9715,432000,835500,96978368,403500,96546368
3,2,0,-37.8095,144.9691,750000,835500,101302400,85500,100552400
1,1,1414,-37.8161,144.9712,375000,2248000,1214461312,1873000,1214086312
1,1,0,-37.8132,144.9545,680000,835500,96968152,155500,96288152
2,1,0,-37.816,144.9535,470000,835500,98334080,365500,97864080
2,1,0,-37.8106,144.9646,483000,835500,98340272,352500,97857272
1,1,0,-37.8157,144.9727,700000,835500,96979648,135500,96279648
2,1,4051,-37.8072,144.9623,520000,2248000,3299839232,1728000,3299319232
1,1,0,-37.8168,144.9691,440000,835500,96977560,395500,96537560
2,2,0,-37.8166,144.9635,733000,835500,99933576,102500,99200576
3,2,0,-37.8095,144.9691,760000,835500,101302400,75500,100542400
2,1,1136,-37.8211,144.9559,360000,2248000,996115520,1888000,995755520
3,1,279,-37.8499,144.957,2600000,2248000,320199776,-352000,317599776
3,1,277,-37.8516,144.9624,2350000,2248000,318622688,-102000,316272688
2,1,760,-37.8474,144.9625,535000,2248000,698970304,1713000,698435304
2,1,0,-37.8556,144.9669,700000,835500,98346976,135500,97646976
4,2,182,-37.8518,144.9663,3120000,2248000,246506192,-872000,243386192
2,1,123,-37.8551,144.968,1025000,2248000,195554336,1223000,194529336
2,1,152,-37.8498,144.9628,1920000,2248000,218469152,328000,216549152
3,2,181,-37.8536,144.9625,2623000,2248000,244347584,-375000,241724584
3,2,151,-37.847,144.9594,1500000,2248000,220635936,748000,219135936
2,1,152,-37.8513,144.9586,1630000,2248000,218466768,618000,216836768
3,1,217,-37.8474,144.9582,1910000,2248000,271201696,338000,269291696
2,1,613,-37.8238,145.1135,1320000,2248000,582886656,928000,581566656
2,2,0,-37.8161,145.1098,750000,835500,100023568,85500,99273568
3,3,1149,-37.812,145.1095,2588000,2248000,1011035712,-340000,1008447712
5,4,355,-37.812,145.1074,1400000,2248000,387862848,848000,386462848
4,2,931,-37.8226,145.1103,2200000,2248000,838525184,48000,836325184
3,2,330,-37.8167,145.107,1310000,2248000,362186720,938000,360876720
4,2,813,-37.8118,145.1065,2335000,2248000,745266368,-87000,742931368
5,1,711,-37.8195,145.1134,1815000,2248000,664433920,433000,662618920
2,2,0,-37.8161,145.1098,725000,835500,100023568,110500,99298568
4,2,2187,-37.8186,145.1134,3900000,2248000,1831142016,-1652000,1827242016
3,2,255,-37.8192,145.111,1200000,2248000,302917056,1048000,301717056
3,2,640,-37.8173,145.1123,1564000,2248000,607182720,684000,605618720
2,1,0,-37.8161,145.1098,520000,835500,98430288,315500,97910288
3,2,0,-37.7672,144.9209,670000,835500,101267752,165500,100597752
3,2,0,-37.7688,144.9054,1055000,835500,101258408,-219500,100203408
2,1,0,-37.7677,144.9221,348000,835500,98309072,487500,97961072
4,3,615,-37.7617,144.9052,1780000,2248000,590250624,468000,588470624
3,2,287,-37.7698,144.9214,1440000,2248000,328084096,808000,326644096
4,1,388,-37.7692,144.9057,1225000,2248000,407667488,1023000,406442488
4,3,384,-37.7617,144.9272,1445000,2248000,407705184,803000,406260184
3,1,328,-37.7658,144.9077,990000,2248000,358884192,1258000,357894192
3,2,477,-37.7661,144.9076,1550000,2248000,478231968,698000,476681968
3,1,443,-37.7585,144.928,1170000,2248000,449780192,1078000,448610192
4,1,571,-37.7659,144.9116,1120000,2248000,552295488,1128000,551175488
4,2,431,-37.7702,144.9268,1530000,2248000,443256704,718000,441726704
3,2,214,-37.7709,144.9334,832000,2248000,270399776,1416000,269567776
2,1,0,-37.7701,144.9079,420000,835500,98300616,415500,97880616
4,4,636,-37.7629,144.9157,2400000,2248000,608446848,-152000,606046848
3,2,0,-37.7672,144.9209,565000,835500,101267752,270500,100702752
2,1,0,-37.7617,144.9367,550000,835500,98317368,285500,97767368
4,1,477,-37.7632,144.9292,1211000,2248000,478017824,1037000,476806824
3,2,408,-37.77,144.913,1630000,2248000,423705088,618000,422075088
3,1,449,-37.7674,144.9084,1160000,2248000,454510976,1088000,453350976
4,1,453,-37.7698,144.9336,1361500,2248000,459054176,886500,457692676
2,1,225,-37.7639,144.9093,945000,2248000,276117984,1303000,275172984
1,1,0,-37.7652,144.9116,360000,835500,96936112,475500,96576112
2,1,301,-37.7695,144.9092,860000,2248000,336181280,1388000,335321280
4,1,539,-37.7701,144.9287,1637000,2248000,527016864,611000,525379864
3,2,249,-37.7609,144.9296,1505000,2248000,298056768,743000,296551768
2,1,1981,-37.7677,144.9221,515000,2248000,1663891072,1733000,1663376072
2,1,0,-37.7715,144.916,330000,835500,98305760,505500,97975760
4,1,549,-37.7696,144.929,1322000,2248000,534920000,926000,533598000
2,1,228,-37.7685,144.9183,1015000,2248000,278494976,1233000,277479976
3,1,307,-37.7704,144.9083,840000,2248000,342288800,1408000,341448800
5,3,646,-37.7625,144.9074,1900000,2248000,616117504,348000,614217504
5,3,619,-37.7691,144.9321,2340000,2248000,594795520,-92000,592455520
3,2,394,-37.7699,144.9149,1400000,2248000,412642112,848000,411242112
4,2,435,-37.7601,144.9228,1640000,2248000,446414304,608000,444774304
3,1,436,-37.7704,144.9292,1480000,2248000,444250208,768000,442770208
2,1,0,-37.7597,144.9188,410000,835500,98306096,425500,97896096
5,2,207,-37.7615,144.9333,980000,2248000,267598960,1268000,266618960
3,2,216,-37.7607,144.9314,842500,2248000,271977984,1405500,271135484
4,2,313,-37.7709,144.9288,1345000,2248000,350002784,903000,348657784
1,1,0,-37.758,144.9237,265000,835500,96942712,570500,96677712
2,1,345,-37.773,144.9335,849000,2248000,370969824,1399000,370120824
3,1,526,-37.7701,144.9172,1425000,2248000,515369664,823000,513944664
3,2,310,-37.7639,144.9126,1345000,2248000,346254912,903000,344909912
2,1,0,-37.7654,144.9094,330000,835500,98300984,505500,97970984
4,2,67,-37.761,144.9262,726000,2248000,155586496,1522000,154860496
3,2,283,-37.7638,144.9175,1250000,2248000,324919840,998000,323669840
3,2,156,-37.7631,144.9357,870000,2248000,224562976,1378000,223692976
3,2,596,-37.7609,144.905,1725000,2248000,572275328,523000,570550328
2,1,166,-37.7624,144.9365,600000,2248000,229506896,1648000,228906896
4,2,441,-37.7627,144.9278,1505000,2248000,451159392,743000,449654392
3,2,271,-37.7682,144.9058,850000,2248000,315429568,1398000,314579568
1,1,0,-37.758,144.9237,292000,835500,96942712,543500,96650712
5,1,739,-37.7613,144.9177,1740000,2248000,686434944,508000,684694944
2,1,0,-37.7677,144.92,470000,835500,98307784,365500,97837784
3,2,217,-37.7704,144.9162,1130000,2248000,272760064,1118000,271630064
3,3,325,-37.7702,144.9091,930000,2248000,359701248,1318000,358771248
1,1,0,-37.7652,144.9116,336000,835500,96936112,499500,96600112
2,2,239,-37.7708,144.9093,800000,2248000,288776224,1448000,287976224
3,1,834,-37.9376,145.0474,1224000,2248000,758881472,1024000,757657472
3,2,573,-37.9428,145.044,1000000,2248000,554205312,1248000,553205312
1,1,106,-37.9374,145.0388,380500,2248000,180806288,1867500,180425788
3,2,784,-37.9368,145.0568,1090000,2248000,720965504,1158000,719875504
3,1,695,-37.9364,145.0559,836000,2248000,649035072,1412000,648199072
3,2,653,-37.9418,145.0549,1417250,2248000,617435776,830750,616018526
2,1,649,-37.9424,145.0464,950000,2248000,611310016,1298000,610360016
4,2,318,-37.9443,145.0448,1140000,2248000,354046048,1108000,352906048
3,2,164,-37.9378,145.0385,750000,2248000,230969200,1498000,230219200
4,3,581,-37.9382,145.0577,1000000,2248000,563495104,1248000,562495104
4,2,696,-37.9398,145.0554,1200000,2248000,652784960,1048000,651584960
3,1,603,-37.9404,145.0464,987000,2248000,576322240,1261000,575335240
3,2,534,-37.9426,145.0568,937000,2248000,523391584,1311000,522454584
4,2,720,-37.9394,145.0408,1426000,2248000,671743104,822000,670317104
4,3,272,-37.9443,145.0444,1016000,2248000,319285312,1232000,318269312
3,2,558,-37.9435,145.0522,901000,2248000,542355968,1347000,541454968
4,3,743,-37.9362,145.0442,1300000,2248000,691515008,948000,690215008
3,1,576,-37.9363,145.0495,975000,2248000,554985600,1273000,554010600
4,2,603,-37.9381,145.0534,1070000,2248000,579285760,1178000,578215760
2,1,83,-37.9355,145.0485,639000,2248000,164001392,1609000,163362392
2,1,180,-37.9363,145.0564,605000,2248000,240665328,1643000,240060328
3,1,593,-37.9431,145.0484,960000,2248000,568420800,1288000,567460800
3,2,374,-37.939,145.0533,725000,2248000,396941120,1523000,396216120
3,2,261,-37.9429,145.0474,800000,2248000,307634272,1448000,306834272
3,2,472,-37.9387,145.0461,917000,2248000,474386016,1331000,473469016
3,1,698,-37.9369,145.0578,890000,2248000,651407232,1358000,650517232
3,2,1660,-37.9354,145.0464,1008000,2248000,1413260800,1240000,1412252800
2,1,756,-37.94,145.0449,1191000,2248000,695870784,1057000,694679784
2,1,209,-37.9389,145.0467,776000,2248000,263578304,1472000,262802304
4,1,688,-37.9411,145.043,1035000,2248000,644861824,1213000,643826824
4,2,588,-37.9395,145.0477,1160000,2248000,567427968,1088000,566267968
1,1,0,-37.9428,145.0584,240000,835500,97047320,595500,96807320
4,2,220,-37.9387,145.0398,1105000,2248000,276593056,1143000,275488056
3,1,281,-37.8457,144.8651,826000,2248000,321723360,1422000,320897360
3,2,194,-37.8395,144.8787,900000,2248000,254568224,1348000,253668224
3,2,283,-37.8477,144.8753,962000,2248000,324903680,1286000,323941680
2,1,244,-37.846,144.8729,800000,2248000,291120864,1448000,290320864
4,1,329,-37.847,144.8788,710000,2248000,361032480,1538000,360322480
4,2,379,-37.8408,144.8893,940000,2248000,402146400,1308000,401206400
3,2,178,-37.8416,144.8651,655800,2248000,241915328,1592200,241259528
4,3,233,-37.841,144.8874,1082000,2248000,288354880,1166000,287272880
3,1,546,-37.8414,144.892,1210000,2248000,531168544,1038000,529958544
3,1,557,-37.834,144.8668,880000,2248000,539845440,1368000,538965440
1,1,0,-37.8413,144.8741,335000,835500,96921960,500500,96586960
4,1,757,-37.8411,144.889,1260000,2248000,699285952,988000,698025952
3,2,2522,-37.8462,144.8944,1400000,2248000,2094394368,848000,2092994368
3,1,316,-37.849,144.8907,995000,2248000,349399904,1253000,348404904
2,1,402,-37.8446,144.8796,962000,2248000,415992064,1286000,415030064
3,2,0,-37.8352,144.8661,800000,835500,101242024,35500,100442024
3,1,357,-37.8459,144.8877,1305000,2248000,381799968,943000,380494968
2,1,0,-37.8421,144.8821,485000,835500,98293192,350500,97808192
3,1,390,-37.847,144.8734,810000,2248000,407871168,1438000,407061168
4,3,425,-37.8456,144.8741,1620000,2248000,440084608,628000,438464608
3,1,221,-37.8415,144.8852,923000,2248000,274317280,1325000,273394280
2,1,470,-37.8471,144.8769,1030000,2248000,469731008,1218000,468701008
3,2,284,-37.8446,144.8861,1046000,2248000,325700256,1202000,324654256
2,2,213,-37.8441,144.8805,740000,2248000,268219344,1508000,267479344
4,1,619,-37.839,144.8854,970000,2248000,590222208,1278000,589252208
3,2,0,-37.8436,144.8691,735000,835500,101244856,100500,100509856
2,1,0,-37.8413,144.8741,485000,835500,98288176,350500,97803176
3,1,453,-37.8414,144.8707,950000,2248000,457657632,1298000,456707632
4,2,458,-37.8427,144.879,1280000,2248000,464573888,968000,463293888
4,2,299,-37.8477,144.8706,1040000,2248000,338911808,1208000,337871808
4,1,0,-37.8423,144.8795,1115000,835500,101024024,-279500,99909024
3,1,767,-37.8466,144.8636,1176000,2248000,705807680,1072000,704631680
4,2,774,-37.8366,144.8758,1265000,2248000,714305536,983000,713040536
2,1,343,-37.8414,144.8752,801000,2248000,369361376,1447000,368560376
3,2,224,-37.8424,144.8653,770000,2248000,278269280,1478000,277499280
3,2,348,-37.8435,144.8788,993000,2248000,376274784,1255000,375281784
2,1,149,-37.8491,144.8903,650000,2248000,216053568,1598000,215403568
3,1,344,-37.8424,144.8754,891500,2248000,371518080,1356500,370626580
3,1,322,-37.8422,144.8784,805000,2248000,354133344,1443000,353328344
2,1,229,-37.8368,144.8768,680000,2248000,279267712,1568000,278587712
2,1,144,-37.845,144.8873,793000,2248000,212099760,1455000,211306760
3,2,753,-37.8413,144.8741,747000,2248000,696342656,1501000,695595656
2,1,297,-37.8501,144.8931,896000,2248000,333019648,1352000,332123648
2,1,168,-37.8475,144.8897,890000,2248000,231068688,1358000,230178688
4,3,278,-37.8468,144.874,930000,2248000,323910784,1318000,322980784
3,1,571,-37.8417,144.8896,1151000,2248000,550924608,1097000,549773608
4,2,753,-37.8413,144.8741,820000,2248000,697708800,1428000,696888800
2,1,315,-37.8465,144.8714,816000,2248000,347231264,1432000,346415264
3,2,487,-37.8438,144.8806,945000,2248000,486127520,1303000,485182520
1,1,129,-37.8491,144.8903,643700,2248000,198881392,1604300,198237692
2,1,255,-37.8469,144.8766,760000,2248000,299816544,1488000,299056544
8,2,663,-37.8385,144.8824,881000,2248000,632051520,1367000,631170520
3,2,360,-37.835,144.8814,900000,2248000,385758944,1348000,384858944
3,3,303,-37.742,144.8885,830000,2248000,342298656,1418000,341468656
4,2,650,-37.7429,144.888,1126000,2248000,616305088,1122000,615179088
3,2,0,-37.7473,144.8897,1235000,835500,101246216,-399500,100011216
2,1,0,-37.7467,144.8906,457000,835500,98287216,378500,97830216
2,2,217,-37.7465,144.8868,660000,2248000,271372960,1588000,270712960
3,2,313,-37.7335,144.8788,770000,2248000,348601376,1478000,347831376
4,3,747,-37.7387,144.8827,1350000,2248000,694553536,898000,693203536
3,2,229,-37.7462,144.8873,820000,2248000,282223040,1428000,281403040
3,1,716,-37.7368,144.8856,991000,2248000,665503040,1257000,664512040
2,2,268,-37.7343,144.8783,657000,2248000,311671520,1591000,311014520
3,2,317,-37.7449,144.8869,710000,2248000,351768928,1538000,351058928
3,2,374,-37.7445,144.8834,840000,2248000,396813792,1408000,395973792
5,2,650,-37.7391,144.8875,1400000,2248000,617670464,848000,616270464
4,3,539,-37.7444,144.8847,1080000,2248000,530173344,1168000,529093344
3,1,643,-37.736,144.8839,1015000,2248000,607810176,1233000,606795176
4,3,0,-37.7386,144.8902,1245000,835500,104204976,-409500,102959976
3,1,643,-37.7449,144.8899,1105000,2248000,607814912,1143000,606709912
4,3,310,-37.7958,144.944,2920000,2248000,349237440,-672000,346317440
2,1,0,-37.7994,144.9464,540000,835500,98327744,295500,97787744
2,1,0,-37.7936,144.9426,726000,835500,98324736,109500,97598736
3,1,83,-37.7987,144.9497,1340000,2248000,165290704,908000,163950704
2,2,88,-37.8018,144.9429,1105000,2248000,169465440,1143000,168360440
2,1,215,-37.7953,144.9437,841000,2248000,268239808,1407000,267398808
2,1,0,-37.7988,144.9475,528500,835500,98328360,307000,97799860
1,1,1045,-37.802,144.9516,410000,2248000,922827264,1838000,922417264
2,1,0,-37.7955,144.9492,550000,835500,98329032,285500,97779032
2,1,0,-37.8044,144.9566,470000,835500,98334624,365500,97864624
2,2,0,-37.802,144.9459,640000,835500,99921032,195500,99281032
2,2,0,-37.8015,144.9526,720000,835500,99925096,115500,99205096
3,2,97,-37.8014,144.949,1325000,2248000,177948048,923000,176623048
1,1,0,-37.8,144.9542,368000,835500,96966400,467500,96598400
2,1,1588,-37.7988,144.9478,450000,2248000,1353323136,1798000,1352873136
3,2,118,-37.7976,144.944,1385000,2248000,194540768,863000,193155768
2,2,584,-37.8016,144.9508,990000,2248000,561458432,1258000,560468432
2,1,0,-37.8022,144.9439,606000,835500,98326552,229500,97720552
1,1,0,-37.802,144.9516,450000,835500,96965048,385500,96515048
3,1,232,-37.7977,144.9512,1470000,2248000,283046016,778000,281576016
2,2,109,-37.795,144.942,1010000,2248000,186060368,1238000,185050368
2,1,161,-37.8043,144.9437,1266000,2248000,225564768,982000,224298768
2,1,0,-37.8004,144.9544,620000,835500,98332808,215500,97712808
2,1,0,-37.8055,144.9547,630000,835500,98333576,205500,97703576
2,1,2300,-37.7997,144.9472,560000,2248000,1916015616,1688000,1915455616
2,2,0,-37.8009,144.9471,665500,835500,99921632,170000,99256132
2,1,1004,-37.7926,144.9441,550055,2248000,891785600,1697945,891235545
1,1,649,-37.7971,144.9448,358000,2248000,609864192,1890000,609506192
1,1,0,-37.7955,144.9492,320000,835500,96962800,515500,96642800
3,2,61,-37.8039,144.9424,1000000,2248000,149493520,1248000,148493520
2,1,0,-37.8044,144.9566,598000,835500,98334624,237500,97736624
2,1,111,-37.8044,144.9481,885000,2248000,186052560,1363000,185167560
2,1,0,-37.7976,144.9454,587134,835500,98326928,248366,97739794
2,1,245,-37.7662,145.0096,1286000,2248000,291985952,962000,290699952
3,1,215,-37.7759,144.9909,1200000,2248000,269632832,1048000,268432832
3,2,286,-37.7708,145.0054,1382500,2248000,327345664,865500,325963164
4,2,464,-37.7805,145.004,1600000,2248000,469385344,648000,467785344
3,1,247,-37.7798,144.9952,1710000,2248000,294925472,538000,293215472
6,2,772,-37.7813,145.0065,2000000,2248000,715531392,248000,713531392
2,2,0,-37.7793,144.9972,583000,835500,99949936,252500,99366936
2,2,55,-37.7627,144.9898,650000,2248000,143409856,1598000,142759856
4,2,415,-37.7807,144.9948,1700000,2248000,430655008,548000,428955008
2,1,607,-37.7668,145.0149,1575000,2248000,578077376,673000,576502376
2,1,191,-37.7715,144.9951,950000,2248000,249301520,1298000,248351520
3,1,472,-37.7765,145.0027,1655000,2248000,472746976,593000,471091976
3,2,259,-37.7687,144.9922,1255000,2248000,305999200,993000,304744200
2,1,347,-37.763,144.9886,1020000,2248000,372583136,1228000,371563136
1,1,0,-37.7842,144.9991,435000,835500,96992200,400500,96557200
2,1,136,-37.7651,145.0027,790000,2248000,205838992,1458000,205048992
2,1,0,-37.7828,145.0096,605000,835500,98364704,230500,97759704
1,1,0,-37.7827,144.9999,385000,835500,96992504,450500,96607504
3,1,445,-37.7652,145.0123,1190000,2248000,451413440,1058000,450223440
3,1,184,-37.7825,145.0104,865000,2248000,245146352,1383000,244281352
4,2,573,-37.7707,144.9924,2175000,2248000,555519552,73000,553344552
1,1,0,-37.7783,144.9954,312000,835500,96989224,523500,96677224
2,1,225,-37.7663,145.0009,890000,2248000,276174624,1358000,275284624
5,3,490,-37.7726,145.0048,2700000,2248000,492892128,-452000,490192128
2,1,229,-37.7784,145.0042,1101000,2248000,279339264,1147000,278238264
3,1,158,-37.7756,144.9891,1050000,2248000,224584672,1198000,223534672
3,1,178,-37.771,144.9974,1010000,2248000,240395200,1238000,239385200
3,1,522,-37.7752,145.0032,1900000,2248000,512262080,348000,510362080
2,1,190,-37.7667,144.9909,888000,2248000,248508080,1360000,247620080
2,1,354,-37.7638,144.9933,1020000,2248000,378118176,1228000,377098176
2,1,174,-37.7642,144.9963,844000,2248000,235866288,1404000,235022288
3,2,608,-37.7763,144.9967,900000,2248000,581817152,1348000,580917152
3,1,328,-37.7745,145.0045,1300000,2248000,358944800,948000,357644800
3,1,150,-37.7648,145.0098,810000,2248000,218273728,1438000,217463728
2,1,0,-37.7711,145.013,701000,835500,98365416,134500,97664416
2,1,120,-37.7715,145.0075,665000,2248000,193197936,1583000,192532936
3,1,899,-37.7822,144.9935,2315000,2248000,810199488,-67000,807884488
2,1,453,-37.7666,145.0132,1170000,2248000,456370304,1078000,455200304
3,1,407,-37.7799,144.9937,1715000,2248000,421372384,533000,419657384
1,1,0,-37.7827,144.9999,422000,835500,96992504,413500,96570504
3,1,304,-37.7642,145.001,1474000,2248000,339974240,774000,338500240
2,1,243,-37.7653,145.0014,1035000,2248000,290400192,1213000,289365192
2,1,0,-37.7641,144.9958,460000,835500,98354016,375500,97894016
3,2,403,-37.7673,145.0081,1760000,2248000,419811840,488000,418051840
2,1,306,-37.7644,145.004,1095000,2248000,340190528,1153000,339095528
3,1,307,-37.764,144.9976,1225000,2248000,342343040,1023000,341118040
2,1,178,-37.777,144.9922,1211000,2248000,239026480,1037000,237815480
2,1,129,-37.7668,145.0063,770000,2248000,200309312,1478000,199539312
3,1,440,-37.7663,145.0118,1000000,2248000,447461792,1248000,446461792
2,1,301,-37.774,145.0081,1050000,2248000,336242656,1198000,335192656
5,3,450,-37.7701,144.9886,1700000,2248000,461269920,548000,459569920
3,2,338,-37.7757,145.0119,2160000,2248000,368445760,88000,366285760
1,1,0,-37.7831,145.0124,400000,835500,97000256,435500,96600256
4,1,465,-37.7662,144.9889,1420000,2248000,468571360,828000,467151360
4,2,489,-37.7762,145.0027,1950000,2248000,489141472,298000,487191472
5,3,344,-37.7677,145.0085,1820000,2248000,377510176,428000,375690176
3,1,348,-37.7799,145.011,1080000,2248000,374755424,1168000,373675424
2,1,0,-37.7766,144.9988,570000,835500,98357312,265500,97787312
2,1,297,-37.7627,144.9986,1340000,2248000,333074304,908000,331734304
4,2,824,-37.7803,145.0063,2340000,2248000,753894272,-92000,751554272
2,1,376,-37.7789,144.9952,1634000,2248000,395507680,614000,393873680
2,1,150,-37.7665,144.9955,910000,2248000,216898928,1338000,215988928
4,1,382,-37.7784,144.9959,1650000,2248000,402982336,598000,401332336
3,1,327,-37.7741,144.9971,1510000,2248000,358149888,738000,356639888
4,1,696,-37.7209,144.9158,865000,2248000,651080000,1383000,650215000
2,1,189,-37.7151,144.9191,476000,2248000,247667520,1772000,247191520
3,1,715,-37.7143,144.9092,706000,2248000,664724672,1542000,664018672
4,2,780,-37.7168,144.9171,920000,2248000,719058752,1328000,718138752
2,1,161,-37.7204,144.9131,522000,2248000,225536080,1726000,225014080
4,1,553,-37.7161,144.9165,690000,2248000,538067264,1558000,537377264
3,2,272,-37.7182,144.9244,770000,2248000,316225376,1478000,315455376
5,2,783,-37.7207,144.9263,1100000,2248000,722802048,1148000,721702048
2,1,118,-37.7232,144.9154,475000,2248000,191554976,1773000,191079976
3,2,198,-37.722,144.9169,651000,2248000,257739136,1597000,257088136
3,2,790,-37.718,144.9124,815500,2248000,725592704,1432500,724777204
3,2,382,-37.7152,144.9165,770000,2248000,403153056,1478000,402383056
2,1,161,-37.7218,144.9188,585500,2248000,225539744,1662500,224954244
4,1,704,-37.7143,144.9096,840000,2248000,657397888,1408000,656557888
2,1,138,-37.7209,144.9179,470000,2248000,207362224,1778000,206892224
3,1,763,-37.7178,144.9121,810000,2248000,702661248,1438000,701851248
4,1,694,-37.718,144.9138,855333,2248000,649497920,1392667,648642587
5,2,568,-37.7129,144.9253,900000,2248000,552886144,1348000,551986144
3,2,258,-37.9156,145.0879,875000,2248000,305285056,1373000,304410056
4,2,214,-37.9244,145.0883,651000,2248000,271879360,1597000,271228360
3,1,533,-37.9348,145.0836,802000,2248000,521023584,1446000,520221584
5,2,558,-37.9366,145.0954,900000,2248000,545114176,1348000,544214176
3,2,575,-37.9215,145.0925,1000000,2248000,555813248,1248000,554813248
4,2,567,-37.9361,145.0816,801347,2248000,550852160,1446653,550050813
3,1,535,-37.9377,145.0856,921000,2248000,522605728,1327000,521684728
6,2,1200,-37.9099,145.0875,1900000,2248000,1053844224,348000,1051944224
2,1,308,-37.9191,145.0855,752500,2248000,341839456,1495500,341086956
3,1,648,-37.9196,145.0876,1067000,2248000,611908608,1181000,610841608
3,1,774,-37.9178,145.0872,1260500,2248000,711485824,987500,710225324
3,1,531,-37.9303,145.082,850500,2248000,519441504,1397500,518591004
3,2,609,-37.9213,145.0854,1068000,2248000,582678976,1180000,581610976
4,2,539,-37.9413,145.0957,937500,2248000,528733056,1310500,527795556
4,2,530,-37.935,145.083,1126000,2248000,521611776,1122000,520485776
2,1,806,-37.9112,145.0873,778000,2248000,735408448,1470000,734630448
4,2,357,-37.7767,144.9403,1230000,2248000,384783648,1018000,383553648
2,1,187,-37.7939,144.9572,1805000,2248000,246119600,443000,244314600
2,2,190,-37.7928,144.9575,2200000,2248000,250083840,48000,247883840
2,1,70,-37.7931,144.9565,1265000,2248000,153654112,983000,152389112
4,1,194,-37.7944,144.9542,1928000,2248000,254382352,320000,252454352
1,1,2488,-37.7829,144.9574,526000,2248000,2063229824,1722000,2062703824
3,2,154,-37.7934,144.9562,2236000,2248000,222998576,12000,220762576
3,2,2401,-37.7818,144.9576,1403000,2248000,1998799872,845000,1997396872
3,1,50,-37.734,144.9416,1120000,2248000,139198256,1128000,138078256
3,1,560,-37.7156,144.9429,770000,2248000,542249280,1478000,541479280
4,1,733,-37.7194,144.9307,975000,2248000,680330112,1273000,679355112
3,1,446,-37.7181,144.9422,780000,2248000,452155072,1468000,451375072
3,1,204,-37.7234,144.9497,600000,2248000,260908000,1648000,260308000
4,2,686,-37.731,144.9486,955000,2248000,644791744,1293000,643836744
4,2,559,-37.7236,144.9347,1196000,2248000,544414336,1052000,543218336
3,1,568,-37.7178,144.9422,731000,2248000,548571456,1517000,547840456
3,1,180,-37.718,144.94,585000,2248000,241934224,1663000,241349224
2,1,113,-37.7269,144.9274,480000,2248000,187611296,1768000,187131296
4,2,215,-37.7247,144.9257,605000,2248000,272546176,1643000,271941176
3,1,821,-37.7153,144.9418,738000,2248000,748516544,1510000,747778544
2,1,111,-37.7152,144.9349,386000,2248000,186033920,1862000,185647920
2,1,159,-37.7291,144.9446,452000,2248000,223975872,1796000,223523872
3,1,192,-37.7177,144.9321,522500,2248000,251412896,1725500,250890396
2,1,520,-37.7204,144.9446,741000,2248000,509272736,1507000,508531736
2,1,156,-37.7311,144.9395,530000,2248000,221602080,1718000,221072080
3,1,438,-37.7338,144.9441,815000,2248000,445835744,1433000,445020744
3,1,406,-37.7269,144.9447,775000,2248000,420545696,1473000,419770696
5,2,705,-37.7328,144.9281,950000,2248000,661161280,1298000,660211280
3,1,570,-37.7273,144.9274,900000,2248000,550144064,1348000,549244064
3,1,422,-37.7337,144.9458,835000,2248000,433191968,1413000,432356968
3,3,291,-37.7271,144.9261,790000,2248000,332836480,1458000,332046480
4,2,455,-37.7207,144.9511,810000,2248000,462233056,1438000,461423056
2,1,147,-37.7209,144.93,500000,2248000,214482352,1748000,213982352
2,1,139,-37.7315,144.9301,485000,2248000,208161232,1763000,207676232
2,1,219,-37.7283,144.9331,488000,2248000,271386688,1760000,270898688
3,2,608,-37.7182,144.9405,900000,2248000,581775680,1348000,580875680
2,1,590,-37.717,144.9509,680000,2248000,564597120,1568000,563917120
3,2,191,-37.7223,144.9315,590000,2248000,252216064,1658000,251626064
3,1,464,-37.7184,144.9488,770000,2248000,466384576,1478000,465614576
3,1,686,-37.7231,144.9252,975000,2248000,641816896,1273000,640841896
4,2,535,-37.7282,144.9462,970000,2248000,525454752,1278000,524484752
3,3,205,-37.7212,144.9326,600000,2248000,264874064,1648000,264274064
2,1,110,-37.7282,144.928,510000,2248000,185240912,1738000,184730912
3,2,540,-37.7174,144.941,750000,2248000,528035648,1498000,527285648
4,2,250,-37.7319,144.9461,822000,2248000,300220032,1426000,299398032
3,2,146,-37.7152,144.9346,430000,2248000,216653696,1818000,216223696
4,2,646,-37.7256,144.9383,1350000,2248000,613172736,898000,611822736
2,1,783,-37.7196,144.9485,810000,2248000,717123648,1438000,716313648
2,1,135,-37.7242,144.9411,550500,2248000,205005984,1697500,204455484
2,1,169,-37.7186,144.9306,610000,2248000,231869024,1638000,231259024
3,2,197,-37.7266,144.9496,533000,2248000,256969520,1715000,256436520
2,1,105,-37.7233,144.9507,410000,2248000,181302832,1838000,180892832
3,1,557,-37.7156,144.943,600000,2248000,539878464,1648000,539278464
3,1,190,-37.7211,144.9508,616000,2248000,249844240,1632000,249228240
3,1,641,-37.7253,144.938,960000,2248000,606261568,1288000,605301568
4,2,511,-37.7268,144.9401,985000,2248000,506483712,1263000,505498712
3,1,596,-37.721,144.9514,670000,2248000,570705856,1578000,570035856
4,2,148,-37.7231,144.9482,665000,2248000,219609776,1583000,218944776
3,2,588,-37.7283,144.9356,880000,2248000,565967936,1368000,565087936
3,1,449,-37.7286,144.9456,700000,2248000,454529312,1548000,453829312
3,2,122,-37.7231,144.9373,600000,2248000,197689104,1648000,197089104
2,1,746,-37.7304,144.9496,1570000,2248000,687884544,678000,686314544
2,1,111,-37.7261,144.9336,525500,2248000,186034400,1722500,185508900
3,1,522,-37.7187,144.9514,612500,2248000,512223488,1635500,511610988
1,1,49,-37.7152,144.9402,248500,2248000,135672480,1999500,135423980
3,2,501,-37.7258,144.9347,960000,2248000,497211072,1288000,496251072
4,1,410,-37.7346,144.9456,650000,2248000,425074560,1598000,424424560
3,1,191,-37.7168,144.9329,500000,2248000,250623040,1748000,250123040
3,1,534,-37.7215,144.951,599000,2248000,521707136,1649000,521108136
3,2,0,-37.8359,144.9342,1150000,835500,101284016,-314500,100134016
3,1,171,-37.8385,144.9409,985000,2248000,234836256,1263000,233851256
3,2,0,-37.841,144.9379,1200000,835500,101286888,-364500,100086888
3,2,250,-37.8381,144.9391,2200000,2248000,298861952,48000,296661952
4,2,611,-37.8349,144.9266,2105000,2248000,585517952,143000,583412952
2,1,0,-37.8408,144.94,550000,835500,98328680,285500,97778680
4,3,323,-37.8371,144.921,1915000,2248000,359502048,333000,357587048
3,2,135,-37.8395,144.9343,1630000,2248000,207974832,618000,206344832
2,2,96,-37.8327,144.9474,1000000,2248000,175794224,1248000,174794224
3,1,153,-37.8382,144.9469,1470000,2248000,220614512,778000,219144512
2,2,0,-37.8431,144.9403,725000,835500,99922416,110500,99197416
2,1,0,-37.8424,144.9449,600000,835500,98331888,235500,97731888
3,2,173,-37.8375,144.941,1342000,2248000,238010064,906000,236668064
1,1,0,-37.8416,144.939,500000,835500,96961944,335500,96461944
2,2,579,-37.8416,144.9381,795000,2248000,557503808,1453000,556708808
2,2,0,-37.8404,144.9391,590000,835500,99921352,245500,99331352
2,2,0,-37.8392,144.9257,1100000,835500,99912960,-264500,98812960
2,2,115,-37.8351,144.9441,1275000,2248000,190808176,973000,189533176
2,1,90,-37.8357,144.9376,1000000,2248000,169453488,1248000,168453488
4,2,212,-37.8331,144.9412,1820000,2248000,270197536,428000,268377536
2,2,0,-37.8392,144.9421,655000,835500,99923056,180500,99268056
2,1,195,-37.8395,144.9462,1350000,2248000,252440592,898000,251090592
3,2,241,-37.8346,144.9448,1560000,2248000,291752416,688000,290192416
2,1,106,-37.8346,144.9373,1060000,2248000,182097936,1188000,181037936
2,2,0,-37.8392,144.9257,1610000,835500,99912960,-774500,98302960
2,1,152,-37.8393,144.9386,1101000,2248000,218453040,1147000,217352040
2,1,163,-37.8359,144.9358,880000,2248000,227144224,1368000,226264224
2,1,105,-37.8338,144.9474,1080000,2248000,181313776,1168000,180233776
2,1,120,-37.8322,144.947,1115000,2248000,193167824,1133000,192052824
2,1,0,-37.8407,144.9389,516000,835500,98327992,319500,97811992
3,2,225,-37.8381,144.9329,1753000,2248000,279100704,495000,277347704
2,1,124,-37.8356,144.9439,900000,2248000,196327504,1348000,195427504
5,1,350,-37.8407,144.9424,2350000,2248000,379033344,-102000,376683344
3,2,140,-37.8353,144.9442,1670000,2248000,211931920,578000,210261920
3,1,108,-37.8332,144.945,1402000,2248000,185049328,846000,183647328
3,2,210,-37.8382,144.9272,1570000,2248000,267242704,678000,265672704
2,1,82,-37.8361,144.9403,1150000,2248000,163132816,1098000,161982816
3,1,184,-37.8348,144.9443,1384000,2248000,245111792,864000,243727792
2,1,0,-37.8416,144.939,655000,835500,98328152,180500,97673152
1,1,0,-37.8405,144.9385,456000,835500,96961512,379500,96505512
2,1,0,-37.8407,144.9389,520000,835500,98327992,315500,97807992
1,1,0,-37.8436,144.944,470000,835500,96965256,365500,96495256
2,1,0,-37.8398,144.9404,600000,835500,98328808,235500,97728808
2,1,0,-37.8424,144.9449,670000,835500,98331888,165500,97661888
2,1,168,-37.8346,144.9453,1400000,2248000,231101408,848000,229701408
3,2,0,-37.8363,144.9336,1520000,835500,101283688,-684500,99763688
1,1,6866,-37.8443,144.9437,600000,2248000,5523156992,1648000,5522556992
3,2,5042,-37.8405,144.9319,2460000,2248000,4085969664,-212000,4083509664
3,2,214,-37.8341,144.9458,3705000,2248000,270414880,-1457000,266709880
3,2,0,-37.8317,144.9446,950000,835500,101289920,-114500,100339920
3,1,114,-37.8371,144.939,1350000,2248000,189787872,898000,188437872
2,1,0,-37.8424,144.9449,735000,835500,98331888,100500,97596888
1,1,0,-37.8392,144.9421,400000,835500,96963568,435500,96563568
2,1,0,-37.8426,144.9398,900000,835500,98328768,-64500,97428768
3,1,0,-37.8373,144.9397,1380000,835500,99694288,-544500,98314288
3,1,116,-37.8401,144.943,1080000,2248000,191371296,1168000,190291296
1,1,0,-37.8486,144.9872,342000,835500,96992432,493500,96650432
2,1,88,-37.8503,144.9913,950000,2248000,167907664,1298000,166957664
2,1,0,-37.8511,145.0029,781000,835500,98368608,54500,97587608
1,1,0,-37.8519,144.9948,549800,835500,96997512,285700,96447712
1,1,1768,-37.851,144.988,492000,2248000,1494241664,1756000,1493749664
1,1,0,-37.857,145.0027,500500,835500,97002976,335000,96502476
3,2,0,-37.847,144.9936,1400000,835500,101321888,-564500,99921888
3,2,0,-37.8496,144.9905,685000,835500,101320280,150500,100635280
3,1,0,-37.8516,144.9943,710000,835500,99729568,125500,99019568
1,1,0,-37.8595,145.0076,330000,835500,97006264,505500,96676264
3,2,128,-37.8526,145.0071,1245000,2248000,202489088,1003000,201244088
2,1,141,-37.852,145.0061,1182500,2248000,209802816,1065500,208620316
2,1,288,-37.8512,145.0053,1303000,2248000,325976128,945000,324673128
1,1,443,-37.8493,145.0006,482500,2248000,447103136,1765500,446620636
2,1,0,-37.8581,145.0017,585000,835500,98368696,250500,97783696
2,1,0,-37.8526,145.0033,1106000,835500,98369032,-270500,97263032
2,1,308,-37.8492,145.0019,1590000,2248000,341779808,658000,340189808
2,1,203,-37.8557,145.0053,1055000,2248000,258801264,1193000,257746264
3,1,111,-37.8525,145.0071,1100000,2248000,187460704,1148000,186360704
2,1,0,-37.851,144.988,530000,835500,98359424,305500,97829424
2,1,222,-37.8501,144.9995,1500000,2248000,273812704,748000,272312704
2,2,0,-37.847,144.9936,841000,835500,99955680,-5500,99114680
2,1,0,-37.8588,145.0024,570000,835500,98369200,265500,97799200
2,1,0,-37.8506,144.9919,560000,835500,98361768,275500,97801768
2,1,96,-37.8501,144.9953,815000,2248000,174232480,1433000,173417480
2,1,183,-37.8543,145.0024,910000,2248000,242993328,1338000,242083328
3,2,1958,-37.8526,145.0106,1450000,2248000,1648738048,798000,1647288048
2,2,113,-37.8481,144.9869,1540000,2248000,189255440,708000,187715440
3,2,273,-37.8544,145.0038,1811000,2248000,317080576,437000,315269576
2,1,214,-37.8577,145.0053,1180000,2248000,267494800,1068000,266314800
3,2,183,-37.8562,145.0042,1720000,2248000,245954128,528000,244234128
3,2,8216,-37.85,144.9876,1050000,2248000,6594412544,1198000,6593362544
2,1,214,-37.8572,145.0066,1582000,2248000,267495520,666000,265913520
2,2,0,-37.8598,145.0097,681000,835500,99967088,154500,99286088
2,1,131,-37.8479,144.9988,1305000,2248000,201894816,943000,200589816
3,1,231,-37.8467,144.9894,1255000,2248000,282284992,993000,281029992
3,2,238,-37.8476,144.9892,2180000,2248000,289410336,68000,287230336
3,2,272,-37.8553,145.007,1720000,2248000,316292352,528000,314572352
3,2,112,-37.8517,145.0056,1220000,2248000,189843280,1028000,188623280
3,2,146,-37.8519,145.0055,1612000,2248000,216713392,636000,215101392
3,1,644,-37.7419,145.0049,1250000,2248000,608675648,998000,607425648
4,2,604,-37.7369,144.9905,930000,2248000,580013696,1318000,579083696
3,1,148,-37.7428,145.0081,751000,2248000,216689488,1497000,215938488
2,1,132,-37.7343,145.0025,715000,2248000,202674080,1533000,201959080
2,1,581,-37.7508,145.0209,837000,2248000,557531520,1411000,556694520
3,1,563,-37.7318,145.0192,950000,2248000,544669056,1298000,543719056
3,1,266,-37.7322,145.0318,496000,2248000,309958112,1752000,309462112
2,1,356,-37.7384,145.0058,850000,2248000,379703520,1398000,378853520
2,1,250,-37.7373,145.0237,540000,2248000,295942688,1708000,295402688
3,1,566,-37.7418,144.9934,1150000,2248000,547025280,1098000,545875280
3,1,493,-37.7441,145.0221,615000,2248000,489351360,1633000,488736360
3,1,369,-37.7359,144.985,735000,2248000,391330496,1513000,390595496
4,2,1034,-37.7379,144.9851,810000,2248000,919838976,1438000,919028976
2,1,220,-37.7442,145.0168,600000,2248000,272230304,1648000,271630304
3,1,452,-37.7307,145.0094,1650000,2248000,456939744,598000,455289744
3,1,503,-37.739,145.0238,600000,2248000,497254752,1648000,496654752
2,1,400,-37.7352,144.9852,722000,2248000,414463584,1526000,413741584
4,3,654,-37.7365,145.0173,1260000,2248000,621138304,988000,619878304
2,1,117,-37.7514,145.0118,485000,2248000,190827312,1763000,190342312
3,1,594,-37.7512,145.017,690000,2248000,569169216,1558000,568479216
2,1,507,-37.7437,144.9995,1065000,2248000,499035392,1183000,497970392
3,1,847,-37.7279,144.9849,1200000,2248000,769092352,1048000,767892352
2,1,106,-37.7306,144.9993,530000,2248000,182123888,1718000,181593888
3,1,472,-37.745,145.0139,900000,2248000,472750144,1348000,471850144
2,1,214,-37.7462,145.0044,700000,2248000,267481104,1548000,266781104
2,2,516,-37.7497,145.011,920000,2248000,507749120,1328000,506829120
3,2,479,-37.7425,145.014,980000,2248000,479875296,1268000,478895296
2,1,467,-37.7345,144.9977,886000,2248000,467421184,1362000,466535184
3,1,487,-37.7511,144.9907,1080000,2248000,484591104,1168000,483511104
4,2,559,-37.7347,144.9966,1400000,2248000,544453760,848000,543053760
2,1,113,-37.7479,145.0153,660000,2248000,187667872,1588000,187007872
2,1,0,-37.7377,144.9899,436000,835500,98347280,399500,97911280
2,1,479,-37.733,144.9961,876000,2248000,476903680,1372000,476027680
2,2,352,-37.7495,145.0092,910000,2248000,378138976,1338000,377228976
3,2,185,-37.7287,144.9869,714000,2248000,247509120,1534000,246795120
2,2,76,-37.7443,145.0015,770000,2248000,160011152,1478000,159241152
3,1,421,-37.738,145.0064,810000,2248000,432439456,1438000,431629456
3,2,590,-37.7336,144.9958,1127000,2248000,567586240,1121000,566459240
2,1,310,-37.7455,144.9954,780000,2248000,343344224,1468000,342564224
2,1,472,-37.7484,144.9886,986000,2248000,471368768,1262000,470382768
4,8,1254,-37.7367,144.9895,760000,2248000,1103267072,1488000,1102507072
3,1,504,-37.7476,144.9842,1123000,2248000,498021760,1125000,496898760
1,1,0,-37.7441,144.9999,300000,835500,96987960,535500,96687960
2,1,493,-37.74,144.9821,890000,2248000,487960064,1358000,487070064
2,2,1485,-37.7476,145.0026,425000,2248000,1273543168,1823000,1273118168
2,1,187,-37.7351,145.0323,515000,2248000,246158928,1733000,245643928
3,1,399,-37.7366,145.0063,1040000,2248000,415052640,1208000,414012640
3,1,495,-37.7521,145.0114,890000,2248000,490926304,1358000,490036304
2,1,266,-37.7423,145.0105,790000,2248000,308579968,1458000,307789968
2,2,415,-37.7481,145.0017,860000,2248000,427923008,1388000,427063008
2,1,372,-37.7348,144.9852,630000,2248000,392335168,1618000,391705168
4,1,400,-37.7371,145.0111,875000,2248000,417212192,1373000,416337192
3,1,333,-37.7423,145.0097,923000,2248000,362895744,1325000,361972744
4,1,396,-37.7361,145.0093,920000,2248000,414049728,1328000,413129728
4,2,561,-37.7369,145.0201,871000,2248000,546049024,1377000,545178024
4,2,243,-37.7506,144.9847,950000,2248000,294713856,1298000,293763856
4,1,400,-37.7346,145.0164,870000,2248000,417215168,1378000,416345168
3,1,713,-37.7436,145.0191,1186000,2248000,663215168,1062000,662029168
2,1,126,-37.7523,145.0091,610000,2248000,197938448,1638000,197328448
3,2,463,-37.7507,144.9921,1162500,2248000,467217984,1085500,466055484
4,1,560,-37.743,144.9914,1142500,2248000,543648576,1105500,542506076
3,1,679,-37.7392,145.0163,930000,2248000,636342784,1318000,635412784
3,2,650,-37.7302,144.998,875000,2248000,615005056,1373000,614130056
4,1,390,-37.7395,144.9843,840000,2248000,409292960,1408000,408452960
3,3,0,-37.75,144.9846,750000,835500,102898216,85500,102148216
4,2,500,-37.732,145.0209,750000,2248000,497840800,1498000,497090800
3,1,191,-37.7019,145.0256,475000,2248000,250678320,1773000,250203320
2,1,189,-37.708,145.0181,415000,2248000,247727632,1833000,247312632
3,1,779,-37.7292,145.0214,731000,2248000,715374592,1517000,714643592
2,1,117,-37.7101,145.0223,352000,2248000,190828912,1896000,190476912
3,1,535,-37.7299,145.0242,723000,2248000,522543520,1525000,521820520
2,1,99,-37.7166,144.9911,336000,2248000,176585104,1912000,176249104
3,1,1262,-37.7139,145.0215,685000,2248000,1097087360,1563000,1096402360
3,2,676,-37.7262,145.0177,1025000,2248000,635564544,1223000,634539544
2,1,91,-37.713,145.0108,490000,2248000,170274416,1758000,169784416
3,1,227,-37.7286,145.0059,805000,2248000,279120096,1443000,278315096
3,2,466,-37.7266,145.0004,1005000,2248000,469591104,1243000,468586104
2,1,234,-37.7182,145.0161,535000,2248000,283291008,1713000,282756008
3,1,4679,-37.7093,145.0012,800000,2248000,3797524992,1448000,3796724992
3,1,543,-37.6946,144.9962,510000,2248000,528844512,1738000,528334512
3,2,649,-37.705,145.0216,651000,2248000,614226368,1597000,613575368
2,1,360,-37.7273,145.0254,365000,2248000,382875456,1883000,382510456
2,1,171,-37.711,145.0027,405000,2248000,233493104,1843000,233088104
3,2,158,-37.7293,145.0216,620500,2248000,226192480,1627500,225571980
1,1,141,-37.7025,144.9887,260000,2248000,208408304,1988000,208148304
3,2,267,-37.7132,145.0075,625000,2248000,312324480,1623000,311699480
2,1,146,-37.719,145.0014,427500,2248000,213735776,1820500,213308276
4,2,581,-37.6926,144.9861,851000,2248000,561828864,1397000,560977864
3,2,479,-37.7271,144.9968,998000,2248000,479862880,1250000,478864880
4,2,630,-37.721,144.9952,1030000,2248000,600562496,1218000,599532496
2,1,180,-37.7283,145.0207,410000,2248000,240618912,1838000,240208912
4,1,518,-37.726,145.0044,1015000,2248000,510462048,1233000,509447048
3,3,618,-37.7154,144.9962,915000,2248000,591305920,1333000,590390920
2,1,149,-37.7177,144.9917,380000,2248000,216100544,1868000,215720544
3,2,229,-37.7036,145.0145,530000,2248000,282296288,1718000,281766288
3,1,270,-37.702,145.0148,592000,2248000,313105280,1656000,312513280
2,1,132,-37.709,145.0219,440000,2248000,202683008,1808000,202243008
3,1,620,-37.7099,144.9938,650000,2248000,589697856,1598000,589047856
2,1,159,-37.7059,145.0115,416000,2248000,224014336,1832000,223598336
3,1,0,-37.7272,145.0057,301000,835500,99721976,534500,99420976
3,1,560,-37.721,144.9885,865000,2248000,542277952,1383000,541412952
3,1,700,-37.7125,145.022,650000,2248000,652939456,1598000,652289456
2,1,184,-37.7043,145.0277,401000,2248000,243781584,1847000,243380584
2,1,168,-37.7167,145.0001,491000,2248000,231121280,1757000,230630280
3,1,564,-37.7196,144.9899,810000,2248000,545439872,1438000,544629872
2,1,229,-37.71,145.0082,555000,2248000,279333728,1693000,278778728
2,1,0,-37.7091,145.0255,350000,835500,98365824,485500,98015824
3,2,215,-37.7257,145.0243,540000,2248000,271240768,1708000,270700768
3,1,750,-37.7107,145.0317,682000,2248000,692460160,1566000,691778160
2,1,83,-37.7171,145.0019,380000,2248000,163947040,1868000,163567040
1,1,96,-37.7175,145.0081,350000,2248000,172858560,1898000,172508560
4,2,820,-37.6945,144.992,750000,2248000,750714176,1498000,749964176
2,1,96,-37.7139,145.0198,495000,2248000,174231552,1753000,173736552
3,1,359,-37.6957,145.0161,500000,2248000,383441920,1748000,382941920
2,1,102,-37.7064,145.0264,350000,2248000,178976512,1898000,178626512
2,1,0,-37.7112,144.9989,335000,835500,98349712,500500,98014712
3,1,592,-37.728,145.0352,546000,2248000,567597056,1702000,567051056
3,1,172,-37.7092,145.0274,400000,2248000,235664608,1848000,235264608
2,1,132,-37.708,145.0223,360000,2248000,202683136,1888000,202323136
3,1,250,-37.6974,145.0213,410000,2248000,297302752,1838000,296892752
2,1,931,-37.7033,145.0169,836000,2248000,834128064,1412000,833292064
2,1,132,-37.709,145.0219,440000,2248000,202683008,1808000,202243008
2,1,104,-37.7104,145.0076,376000,2248000,180546016,1872000,180170016
2,1,0,-37.7093,145.0084,323000,835500,98355328,512500,98032328
3,1,527,-37.6983,144.9941,680000,2248000,516198880,1568000,515518880
2,1,0,-37.7141,145.0047,530000,835500,98353616,305500,97823616
4,3,595,-37.7283,145.0072,786000,2248000,574503552,1462000,573717552
2,1,122,-37.7261,144.9961,390000,2248000,194766176,1858000,194376176
3,1,468,-37.7184,144.9962,650000,2248000,469574944,1598000,468924944
3,2,574,-37.722,144.9922,800000,2248000,554937856,1448000,554137856
2,1,90,-37.7295,145.0243,330000,2248000,169494384,1918000,169164384
3,1,474,-37.7086,144.9919,539000,2248000,474312896,1709000,473773896
3,1,456,-37.7038,145.0281,622500,2248000,460109216,1625500,459486716
4,2,834,-37.704,145.0299,767500,2248000,761802816,1480500,761035316
3,1,464,-37.7245,145.004,780000,2248000,466419232,1468000,465639232
3,2,618,-37.6989,145.0212,668000,2248000,589726144,1580000,589058144
3,1,159,-37.7277,145.0248,470000,2248000,225391280,1778000,224921280
3,2,456,-37.7061,145.0308,655000,2248000,461704448,1593000,461049448
2,1,183,-37.7078,145.033,440000,2248000,242994976,1808000,242554976
3,2,597,-37.7066,145.0203,703000,2248000,573130112,1545000,572427112
2,1,141,-37.7149,145.0009,424000,2248000,209783472,1824000,209359472
3,1,745,-37.7007,144.9815,613000,2248000,688476608,1635000,687863608
3,1,535,-37.692,144.9781,475000,2248000,522510752,1773000,522035752
3,2,565,-37.7196,144.997,950000,2248000,547827776,1298000,546877776
4,1,770,-37.6981,144.9989,730000,2248000,709610624,1518000,708880624
3,1,950,-37.7022,145.0078,905000,2248000,850504192,1343000,849599192
2,2,145,-37.7053,145.0173,480000,2248000,214546928,1768000,214066928
3,1,561,-37.7098,145.0031,767000,2248000,543075904,1481000,542308904
3,1,179,-37.7108,145.0289,450000,2248000,241197792,1798000,240747792
3,2,527,-37.7238,144.9964,921500,2248000,517796576,1326500,516875076
2,1,126,-37.7186,145.0166,490000,2248000,197939088,1758000,197449088
3,1,563,-37.7258,145.0129,787000,2248000,544664384,1461000,543877384
2,1,0,-37.7112,144.9989,300000,835500,98349712,535500,98049712
2,1,0,-37.7112,144.9989,335000,835500,98349712,500500,98014712
3,1,521,-37.7097,144.9912,475000,2248000,511456672,1773000,510981672
2,1,153,-37.7098,145.0211,440000,2248000,219278928,1808000,218838928
1,1,0,-37.7111,144.9919,216000,835500,96979168,619500,96763168
1,1,0,-37.7111,144.9919,220000,835500,96979168,615500,96759168
2,1,151,-37.7126,144.99,340000,2248000,217679488,1908000,217339488
1,1,94,-37.7186,145.011,395000,2248000,171279872,1853000,170884872
2,1,585,-37.719,144.9972,790000,2248000,560674368,1458000,559884368
3,1,460,-37.6917,144.9755,601000,2248000,463236608,1647000,462635608
2,1,87,-37.7174,145.0016,300000,2248000,167108080,1948000,166808080
2,1,153,-37.702,145.0324,420000,2248000,219284944,1828000,218864944
4,2,936,-37.7021,145.0178,885000,2248000,842405632,1363000,841520632
3,1,550,-37.7208,144.9887,815000,2248000,534375072,1433000,533560072
3,2,681,-37.7217,145.0163,882500,2248000,639514688,1365500,638632188
3,1,589,-37.7195,144.9982,793000,2248000,565202432,1455000,564409432
3,2,260,-37.7106,145.0225,550000,2248000,306801312,1698000,306251312
2,1,236,-37.6984,144.9997,433000,2248000,284859232,1815000,284426232
2,1,750,-37.7089,145.0192,680000,2248000,691085952,1568000,690405952
3,1,826,-37.7013,145.0244,851000,2248000,752517248,1397000,751666248
3,1,670,-37.7242,145.0154,1025000,2248000,629227776,1223000,628202776
3,1,602,-37.7115,145.0009,784000,2248000,575476992,1464000,574692992
4,1,895,-37.7285,144.9964,1186000,2248000,808400000,1062000,807214000
4,2,508,-37.7129,145.0047,885000,2248000,504150944,1363000,503265944
3,1,807,-37.704,144.9864,718500,2248000,737478464,1529500,736759964
5,2,548,-37.7099,145.0333,762500,2248000,537146368,1485500,536383868
2,1,383,-37.7103,145.0037,610000,2248000,401036960,1638000,400426960
4,1,561,-37.697,144.9989,680000,2248000,544438080,1568000,543758080
2,1,133,-37.6983,144.9998,390000,2248000,203458448,1858000,203068448
2,1,125,-37.8106,144.994,937000,2248000,197145712,1311000,196208712
3,1,203,-37.8166,144.9945,1260000,2248000,260156240,988000,258896240
2,1,0,-37.8164,145.0136,795250,835500,98371112,40250,97575862
2,1,0,-37.824,144.9918,582000,835500,98358592,253500,97776592
1,1,502,-37.8214,144.9997,370000,2248000,493726944,1878000,493356944
1,1,8223,-37.8127,145.0094,421000,2248000,6595628544,1827000,6595207544
5,3,618,-37.8157,145.0073,3200000,2248000,594056960,-952000,590856960
2,1,0,-37.8258,145.0057,479000,835500,98367360,356500,97888360
2,1,1725,-37.8174,144.9949,655000,2248000,1461625216,1593000,1460970216
2,1,2571,-37.8198,145.005,561000,2248000,2130224384,1687000,2129663384
2,2,2740,-37.8231,144.9906,635000,2248000,2265369856,1613000,2264734856
3,1,199,-37.8193,144.9993,1010000,2248000,256998288,1238000,255988288
2,1,169,-37.8235,145.0035,1025000,2248000,231926208,1223000,230901208
2,1,0,-37.815,145.0089,550000,835500,98368056,285500,97818056
4,2,58,-37.817,145.0135,1375000,2248000,148534128,873000,147159128
2,2,220,-37.8284,144.9989,1506000,2248000,273822464,742000,272316464
3,1,332,-37.8131,145.005,1350000,2248000,362110848,898000,360760848
1,1,7455,-37.822,145.0104,405000,2248000,5988681216,1843000,5988276216
1,1,0,-37.8127,145.0094,327000,835500,97001888,508500,96674888
3,1,238,-37.8167,144.9977,1474000,2248000,287818688,774000,286344688
3,1,250,-37.8167,144.9978,1555000,2248000,297302272,693000,295747272
1,1,0,-37.8198,145.005,500000,835500,97000008,335500,96500008
1,1,8223,-37.8127,145.0094,345000,2248000,6595628544,1903000,6595283544
3,1,204,-37.8285,145.0022,1275000,2248000,260952640,973000,259677640
3,1,176,-37.8116,145.0042,1150000,2248000,238823536,1098000,237673536
4,1,254,-37.8201,144.9898,950000,2248000,301825216,1298000,300875216
2,1,0,-37.8231,144.9906,270000,835500,98357752,565500,98087752
1,1,3516,-37.8183,144.9979,439000,2248000,2875685888,1809000,2875246888
2,1,0,-37.8333,144.998,695000,835500,98363504,140500,97668504
2,1,0,-37.8198,144.996,512000,835500,98360680,323500,97848680
2,1,92,-37.815,145.008,855000,2248000,171074992,1393000,170219992
2,2,0,-37.8198,145.005,1040000,835500,99959504,-204500,98919504
1,1,0,-37.8214,144.9896,342000,835500,96990720,493500,96648720
1,1,0,-37.8231,144.9906,681000,835500,96991536,154500,96310536
2,1,95,-37.8193,144.9976,900000,2248000,173439984,1348000,172539984
3,2,120,-37.8243,145.0034,1250000,2248000,196161104,998000,194911104
2,1,117,-37.812,144.9939,990000,2248000,190823424,1258000,189833424
2,1,158,-37.8232,145.0002,1189000,2248000,223230848,1059000,222041848
2,1,166,-37.8245,144.9933,1220000,2248000,229549152,1028000,228329152
3,1,162,-37.8241,145.0015,1100000,2248000,227759184,1148000,226659184
2,1,0,-37.8173,144.9965,450000,835500,98360696,385500,97910696
3,1,245,-37.8138,144.9921,1074000,2248000,293346976,1174000,292272976
2,2,153,-37.8209,145.0055,1430000,2248000,220875648,818000,219445648
3,2,233,-37.8122,144.9937,1465000,2248000,285457472,783000,283992472
2,1,0,-37.812,145.0029,391000,835500,98364008,444500,97973008
2,1,97,-37.814,145.002,930000,2248000,175022640,1318000,174092640
3,1,199,-37.8139,145.0039,1182000,2248000,257000512,1066000,255818512
2,1,151,-37.8171,145.009,777500,2248000,217703472,1470500,216925972
3,2,129,-37.824,145.0052,1115000,2248000,203274848,1133000,202159848
3,2,0,-37.8331,144.9975,760000,835500,101322648,75500,100562648
2,1,0,-37.8173,144.9965,640000,835500,98360696,195500,97720696
3,1,198,-37.8225,145.0007,1420000,2248000,256209280,828000,254789280
1,1,0,-37.8195,145.0103,390000,835500,97003240,445500,96613240
1,1,0,-37.8127,145.0094,380000,835500,97001888,455500,96621888
2,1,0,-37.823,144.9982,680000,835500,98362408,155500,97682408
2,1,126,-37.814,145.006,1081000,2248000,197943776,1167000,196862776
2,2,74,-37.8207,145.0053,860000,2248000,158441888,1388000,157581888
2,1,139,-37.8118,144.9937,905000,2248000,208209840,1343000,207304840
2,2,0,-37.8231,144.9906,691000,835500,99951024,144500,99260024
3,3,168,-37.8126,145.0064,1088000,2248000,235689184,1160000,234601184
3,2,0,-37.8238,145.0072,911000,835500,101327520,-75500,100416520
4,3,544,-37.8152,144.9922,3001000,2248000,534199296,-753000,531198296
2,2,0,-37.822,145.0104,638000,835500,99963080,197500,99325080
3,3,58,-37.8139,145.0012,900000,2248000,148753248,1348000,147853248
3,1,210,-37.8247,145.0001,1695000,2248000,265692720,553000,263997720
3,1,301,-37.8134,145.0055,1365000,2248000,337611904,883000,336246904
2,1,200,-37.8294,145.0029,1045000,2248000,256425824,1203000,255380824
4,2,263,-37.8261,145.0127,1591000,2248000,310545984,657000,308954984
3,2,132,-37.822,145.0041,1275000,2248000,205644848,973000,204369848
4,2,0,-37.8206,145.0099,1510000,835500,102695016,-674500,101185016
3,2,131,-37.8132,144.9929,1550000,2248000,204846608,698000,203296608
3,2,157,-37.8225,145.0029,1456000,2248000,225401600,792000,223945600
3,2,66,-37.8181,145.007,1100000,2248000,153486432,1148000,152386432
2,1,138,-37.8218,145.0132,1045000,2248000,207432720,1203000,206387720
3,2,217,-37.8158,144.9931,2000000,2248000,272812736,248000,270812736
2,1,0,-37.8333,144.998,646000,835500,98363504,189500,97717504
2,2,0,-37.8166,145.0036,660000,835500,99958256,175500,99298256
2,1,197,-37.8215,145.0054,1145000,2248000,254055536,1103000,252910536
4,1,254,-37.8201,144.9898,905000,2248000,301825216,1343000,300920216
2,2,0,-37.8128,145.0133,750000,835500,99963792,85500,99213792
2,2,0,-37.8189,145.0131,604000,835500,99964376,231500,99360376
4,2,249,-37.8147,145.0084,1645000,2248000,299477792,603000,297832792
1,1,0,-37.8242,145.0026,306000,835500,96999048,529500,96693048
3,1,181,-37.8203,145.0092,1270000,2248000,242779152,978000,241509152
3,2,203,-37.8214,145.0132,1850000,2248000,261761568,398000,259911568
3,2,312,-37.8217,145.007,1650000,2248000,347900352,598000,346250352
3,2,171,-37.8166,144.9987,1320000,2248000,236462528,928000,235142528
3,2,192,-37.8212,144.9985,1651000,2248000,253059232,597000,251408232
4,2,288,-37.8268,145.0129,1800000,2248000,330303616,448000,328503616
3,2,0,-37.8189,145.0131,791500,835500,101330584,44000,100539084
3,2,80,-37.8233,144.9947,1600000,2248000,164543680,648000,162943680
2,2,170,-37.8229,144.9931,1200000,2248000,234303328,1048000,233103328
3,2,189,-37.82,144.9987,1555000,2248000,250688304,693000,249133304
3,3,119,-37.8278,144.9984,1582000,2248000,196961392,666000,195379392
3,1,331,-37.8263,145.0085,2055000,2248000,361324224,193000,359269224
3,1,209,-37.8206,144.9913,1345000,2248000,264896512,903000,263551512
1,1,0,-37.822,145.0104,410000,835500,97003592,425500,96593592
2,2,0,-37.822,145.0104,696000,835500,99963080,139500,99267080
3,2,133,-37.8183,145.0079,1350000,2248000,206437024,898000,205087024
2,2,0,-37.8128,145.0139,807000,835500,99964144,28500,99157144
1,1,0,-37.8331,144.9975,385000,835500,96996952,450500,96611952
2,1,156,-37.8209,145.0052,1150000,2248000,221653072,1098000,220503072
4,1,434,-37.8185,145.0061,1775000,2248000,444088800,473000,442313800
3,1,152,-37.8219,145.0096,1270000,2248000,219860912,978000,218590912
2,1,127,-37.8251,145.0063,827500,2248000,198735568,1420500,197908068
2,2,0,-37.8189,145.0131,560000,835500,99964376,275500,99404376
2,2,0,-37.8198,145.005,790000,835500,99959504,45500,99169504
4,3,108,-37.8129,145.0013,1212500,2248000,189634352,1035500,188421852
2,1,103,-37.8199,144.9911,1125000,2248000,179758432,1123000,178633432
3,1,248,-37.8185,144.9935,1520000,2248000,295719264,728000,294199264
5,2,629,-37.7395,145.0773,1101500,2248000,601191104,1146500,600089604
4,2,843,-37.7348,145.0656,1020000,2248000,768941120,1228000,767921120
3,1,213,-37.7386,145.0733,560000,2248000,268098576,1688000,267538576
3,1,1016,-37.7299,145.0656,1050000,2248000,902702656,1198000,901652656
2,1,83,-37.747,145.07,531000,2248000,163992464,1717000,163461464
3,1,454,-37.7449,145.072,620000,2248000,458560544,1628000,457940544
3,1,627,-37.7367,145.0797,780000,2248000,595285952,1468000,594505952
4,1,403,-37.7437,145.0633,821000,2248000,419616000,1427000,418795000
4,3,0,-37.7449,145.0596,915000,835500,104309984,-79500,103394984
4,3,583,-37.733,145.0694,890000,2248000,565058752,1358000,564168752
2,1,164,-37.7362,145.079,430000,2248000,228010928,1818000,227580928
3,2,323,-37.7359,145.0614,1012000,2248000,356617056,1236000,355605056
3,1,927,-37.7342,145.0658,1020000,2248000,832366784,1228000,831346784
4,2,604,-37.7435,145.0686,1270000,2248000,580062592,978000,578792592
3,2,606,-37.7347,145.0783,515000,2248000,580281920,1733000,579766920
3,1,355,-37.7352,145.0713,867000,2248000,380319328,1381000,379452328
3,1,625,-37.7412,145.0642,945000,2248000,593696384,1303000,592751384
2,1,151,-37.7458,145.0609,618000,2248000,217727040,1630000,217109040
3,2,217,-37.7388,145.0742,601000,2248000,272853600,1647000,272252600
3,1,692,-37.7345,145.0753,908000,2248000,646652352,1340000,645744352
3,1,350,-37.8094,144.8869,1145000,2248000,376263072,1103000,375118072
3,1,137,-37.8078,144.8972,970000,2248000,207935600,1278000,206965600
3,3,227,-37.8033,144.8897,1325000,2248000,282243872,923000,280918872
2,1,0,-37.8087,144.8978,450000,835500,98298936,385500,97848936
3,3,168,-37.8066,144.887,1330000,2248000,235614992,918000,234284992
3,2,306,-37.8038,144.8896,1075000,2248000,343084224,1173000,342009224
3,3,227,-37.8033,144.8897,1350000,2248000,282243872,898000,280893872
4,2,299,-37.8087,144.8952,1201000,2248000,338922368,1047000,337721368
3,1,371,-37.8066,144.8853,990000,2248000,392858048,1258000,391868048
2,1,126,-37.8045,144.8898,720000,2248000,197871168,1528000,197151168
3,1,216,-37.8052,144.8941,880000,2248000,270367008,1368000,269487008
3,2,0,-37.8057,144.8857,920000,835500,101250616,-84500,100330616
3,1,467,-37.8093,144.8941,1395000,2248000,468732480,853000,467337480
3,1,217,-37.8037,144.8874,965000,2248000,271152960,1283000,270187960
3,2,309,-37.807,144.898,920000,2248000,345460640,1328000,344540640
3,2,193,-37.8065,144.8866,875000,2248000,253778912,1373000,252903912
2,2,228,-37.8034,144.8855,822500,2248000,280072096,1425500,279249596
3,1,234,-37.8051,144.8858,1080000,2248000,284587232,1168000,283507232
5,3,386,-37.8078,144.8846,1275000,2248000,410631168,973000,409356168
2,1,148,-37.8084,144.8907,955000,2248000,215258736,1293000,214303736
4,2,571,-37.809,144.8865,1455000,2248000,553878336,793000,552423336
2,1,0,-37.8042,144.892,533000,835500,98294832,302500,97761832
4,2,149,-37.8047,144.8948,970000,2248000,220376832,1278000,219406832
2,1,0,-37.8066,144.8971,355000,835500,98298248,480500,97943248
3,1,224,-37.8067,144.8934,1032000,2248000,276689152,1216000,275657152
4,1,352,-37.8059,144.8899,1270000,2248000,379211296,978000,377941296
2,1,172,-37.81,144.8896,815000,2248000,234225424,1433000,233410424
2,2,0,-37.8341,144.9713,593000,835500,99940432,242500,99347432
3,2,88,-37.8363,144.9628,1600000,2248000,170847952,648000,169247952
4,2,163,-37.8355,144.951,1620000,2248000,231479216,628000,229859216
3,1,149,-37.8374,144.9495,1270000,2248000,217454832,978000,216184832
3,1,276,-37.838,144.9489,2633000,2248000,317822496,-385000,315189496
3,1,181,-37.8365,144.9631,1405000,2248000,242752672,843000,241347672
4,3,190,-37.8377,144.9653,2260000,2248000,254419616,-12000,252159616
3,2,171,-37.8391,144.9501,1595000,2248000,236435264,653000,234840264
2,1,0,-37.8369,144.968,595000,835500,98345456,240500,97750456
2,1,0,-37.8341,144.9713,490000,835500,98347152,345500,97857152
3,2,224,-37.8329,144.9529,1250000,2248000,278322080,998000,277072080
4,3,200,-37.836,144.965,2180000,2248000,262322224,68000,260142224
2,1,115,-37.8345,144.9685,930000,2248000,189229824,1318000,188299824
3,2,113,-37.8346,144.9688,1200000,2248000,190608896,1048000,189408896
3,2,161,-37.8383,144.9499,2000000,2248000,228532064,248000,226532064
2,2,141,-37.8389,144.9612,2000000,2248000,211366896,248000,209366896
2,2,0,-37.8372,144.9672,1050000,835500,99938272,-214500,98888272
3,2,108,-37.8363,144.9509,1250000,2248000,186646608,998000,185396608
3,2,204,-37.8357,144.9531,1650000,2248000,262516576,598000,260866576
2,1,0,-37.8308,144.9694,561000,835500,98345600,274500,97784600
3,2,151,-37.8383,144.9632,1825000,2248000,220637264,423000,218812264
2,2,131,-37.839,144.948,1200000,2248000,203455808,1048000,202255808
3,2,138,-37.8351,144.9675,1390000,2248000,210365664,858000,208975664
4,3,577,-37.8357,144.9502,1615000,2248000,560255680,633000,558640680
3,2,0,-37.8352,144.952,2300000,835500,101294888,-1464500,98994888
3,2,0,-37.8319,144.9682,742000,835500,101304464,93500,100562464
3,2,141,-37.8333,144.9576,2075000,2248000,212730208,173000,210655208
2,1,0,-37.8393,144.9886,722000,835500,98358416,113500,97636416
2,2,0,-37.8411,144.9944,850000,835500,99955472,-14500,99105472
3,2,0,-37.8453,144.9849,1230000,835500,101316320,-394500,100086320
2,1,0,-37.8374,144.9918,535000,835500,98360168,300500,97825168
2,2,0,-37.8379,144.9913,990000,835500,99953192,-154500,98963192
2,1,0,-37.8361,144.9842,695000,835500,98355328,140500,97660328
2,1,0,-37.8394,144.9886,775000,835500,98358432,60500,97583432
2,1,0,-37.8368,144.9857,572000,835500,98356336,263500,97784336
3,2,181,-37.8334,144.9867,1460000,2248000,244360080,788000,242900080
2,1,0,-37.8426,144.993,623500,835500,98361504,212000,97738004
1,1,0,-37.8414,144.991,409000,835500,96993920,426500,96584920
3,2,80,-37.8416,144.9923,1250000,2248000,164544336,998000,163294336
2,1,0,-37.8314,144.9877,659000,835500,98356936,176500,97697936
2,1,0,-37.8343,144.9899,780000,835500,98358616,55500,97578616
2,1,225,-37.8421,144.9876,1455000,2248000,276175360,793000,274720360
1,1,0,-37.8404,145.0045,360500,835500,97002120,475000,96641620
2,2,0,-37.8376,144.9847,1300000,835500,99949088,-464500,98649088
2,2,0,-37.8376,144.9847,1300000,835500,99949088,-464500,98649088
1,1,0,-37.8415,144.991,380000,835500,96993944,455500,96613944
4,2,292,-37.8377,144.9894,5700000,2248000,333451584,-3452000,327751584
1,1,0,-37.8375,145.0012,515000,835500,96999760,320500,96484760
3,2,215,-37.8361,144.9831,2695000,2248000,271228352,-447000,268533352
1,1,0,-37.8444,145.0037,310000,835500,97002088,525500,96692088
2,1,0,-37.8407,145.004,627500,835500,98368056,208000,97740556
1,1,0,-37.837,144.9931,425000,835500,96994704,410500,96569704
1,1,0,-37.8437,144.9904,330000,835500,96993832,505500,96663832
2,1,2122,-37.8383,145.0014,693000,2248000,1775380352,1555000,1774687352
3,2,221,-37.8416,144.9959,2285000,2248000,275978688,-37000,273693688
3,3,191,-37.836,144.9824,3000000,2248000,253854032,-752000,250854032
2,1,734,-37.8433,144.9962,515000,2248000,678442880,1733000,677927880
2,1,0,-37.8336,144.9882,600000,835500,98357504,235500,97757504
4,2,141,-37.8366,144.9827,2600000,2248000,214112288,-352000,211512288
1,1,0,-37.8437,144.9904,320000,835500,96993832,515500,96673832
1,1,0,-37.8355,144.9884,400000,835500,96991640,435500,96591640
3,1,211,-37.8442,144.9928,1810000,2248000,266480816,438000,264670816
1,1,0,-37.8368,144.9848,567500,835500,96989576,268000,96422076
1,1,480,-37.8356,144.9767,540000,2248000,476327872,1708000,475787872
3,2,163,-37.8425,144.9877,2010000,2248000,230136416,238000,228126416
3,2,194,-37.8395,144.9898,1945000,2248000,254636624,303000,252691624
3,1,154,-37.8395,144.9868,906000,2248000,221429536,1342000,220523536
1,1,0,-37.8406,145.0035,367000,835500,97001520,468500,96634520
2,1,132,-37.8446,144.9896,1130000,2248000,202679072,1118000,201549072
2,1,0,-37.835,145.0002,500000,835500,98365048,335500,97865048
1,1,0,-37.8319,144.9876,310000,835500,96990720,525500,96680720
2,1,176,-37.8436,144.9925,1100000,2248000,237453904,1148000,236353904
1,1,0,-37.8427,145.0006,410000,835500,96999984,425500,96589984
3,1,146,-37.8454,144.9888,1125000,2248000,215109088,1123000,213984088
2,2,0,-37.8361,144.9966,840000,835500,99956240,-4500,99116240
3,2,0,-37.8433,145.0001,1400000,835500,101325448,-564500,99925448
2,1,0,-37.837,144.9907,680500,835500,98359440,155000,97678940
1,1,0,-37.8423,144.997,280000,835500,96997720,555500,96717720
2,1,0,-37.8323,144.9876,520000,835500,98356976,315500,97836976
2,1,176,-37.8436,144.9925,1200000,2248000,237453904,1048000,236253904
2,1,0,-37.8337,144.9886,480000,835500,98357760,355500,97877760
3,2,358,-37.8425,145.0031,2200000,2248000,384254144,48000,382054144
3,1,178,-37.8404,145.0022,1700000,2248000,240406288,548000,238706288
2,1,163,-37.8446,144.9879,1200000,2248000,227177296,1048000,225977296
3,2,149,-37.8448,144.9882,1540000,2248000,219072816,708000,217532816
2,1,0,-37.8342,144.9842,826000,835500,98355112,9500,97529112
3,2,181,-37.8334,144.9867,1700000,2248000,244360080,548000,242660080
2,1,0,-37.8453,145.0012,505000,835500,98366880,330500,97861880
3,1,0,-37.8235,144.9655,720000,835500,99708552,115500,98988552
3,2,0,-37.8267,144.9687,868000,835500,101304168,-32500,100436168
2,1,0,-37.8246,144.9632,530000,835500,98341048,305500,97811048
2,2,0,-37.8273,144.9556,650000,835500,99929968,185500,99279968
4,3,0,-37.8267,144.9687,990000,835500,104263656,-154500,103273656
2,2,0,-37.8227,144.9664,592500,835500,99936072,243000,99343572
2,2,0,-37.828,144.9683,600000,835500,99937872,235500,99337872
1,1,760,-37.8228,144.9661,455000,2248000,697603520,1793000,697148520
4,3,0,-37.8267,144.9687,1250000,835500,104263656,-414500,103013656
1,1,0,-37.8245,144.9622,425000,835500,96974208,410500,96549208
3,2,0,-37.828,144.9683,740000,835500,101304072,95500,100564072
2,1,0,-37.8288,144.9679,660000,835500,98344432,175500,97684432
2,2,2955,-37.8299,144.9679,622500,2248000,2435270656,1625500,2434648156
2,2,0,-37.8229,144.9612,800000,835500,99932888,35500,99132888
2,2,0,-37.822,144.9637,540000,835500,99934336,295500,99394336
1,1,546,-37.8274,144.9587,370000,2248000,528475520,1878000,528105520
3,1,326,-37.831,144.8884,855000,2248000,357299424,1393000,356444424
2,1,562,-37.8333,144.8868,832500,2248000,542442944,1415500,541610444
2,1,502,-37.8263,144.8775,850000,2248000,495018528,1398000,494168528
3,1,472,-37.8302,144.8885,1080000,2248000,472683008,1168000,471603008
3,1,274,-37.8282,144.8856,927000,2248000,316201792,1321000,315274792
4,2,389,-37.8284,144.8861,850000,2248000,410045952,1398000,409195952
3,1,353,-37.8309,144.889,831000,2248000,378637792,1417000,377806792
4,3,278,-37.8261,144.8718,840000,2248000,323906976,1408000,323066976
4,2,830,-37.829,144.8807,1315000,2248000,758564480,933000,757249480
4,2,742,-37.8248,144.8707,1161000,2248000,689011584,1087000,687850584
3,1,320,-37.8277,144.8841,1016000,2248000,352554528,1232000,351538528
3,1,532,-37.8248,144.8717,690000,2248000,520089920,1558000,519399920
3,1,526,-37.8267,144.8779,1070000,2248000,515352160,1178000,514282160
4,2,389,-37.8284,144.8861,871500,2248000,410045952,1376500,409174452
1,1,0,-37.8656,144.9782,380000,835500,96988896,455500,96608896
2,1,0,-37.8675,144.9851,430000,835500,98359584,405500,97929584
2,1,0,-37.8707,144.9765,602000,835500,98354664,233500,97752664
2,1,0,-37.8573,144.9825,575000,835500,98356768,260500,97781768
2,1,0,-37.8616,144.9907,495000,835500,98362328,340500,97867328
2,1,5530,-37.859,144.9767,500000,2248000,4468705792,1748000,4468205792
3,2,384,-37.8645,144.9805,1891000,2248000,404790592,357000,402899592
4,2,420,-37.8667,144.9832,2000000,2248000,434609504,248000,432609504
3,1,1669,-37.8646,144.9786,1500000,2248000,1418730112,748000,1417230112
3,2,176,-37.8641,144.9739,2000000,2248000,240404320,248000,238404320
1,1,2335,-37.8571,144.987,500000,2248000,1942341120,1748000,1941841120
2,2,0,-37.8568,144.9873,685000,835500,99952952,150500,99267952
1,1,2879,-37.863,144.9747,380000,2248000,2372256768,1868000,2371876768
3,2,0,-37.8573,144.9825,616000,835500,101316256,219500,100700256
1,1,0,-37.8605,144.9769,400000,835500,96987496,435500,96587496
1,1,0,-37.8731,144.9799,451000,835500,96990824,384500,96539824
3,2,128,-37.8624,144.9768,1400000,2248000,202471600,848000,201071600
1,1,0,-37.8568,144.9873,459000,835500,96993464,376500,96534464
2,1,1034,-37.8717,144.9829,520000,2248000,915527680,1728000,915007680
1,1,0,-37.8722,144.9805,370500,835500,96991080,465000,96620580
5,3,1294,-37.8589,144.9883,5046000,2248000,1128292352,-2798000,1123246352
1,1,0,-37.8614,144.9741,385000,835500,96985880,450500,96600880
3,2,289,-37.8726,144.9782,1900000,2248000,329711744,348000,327811744
2,1,0,-37.859,144.9767,390000,835500,98353400,445500,97963400
1,1,0,-37.8668,144.9801,500000,835500,96990216,335500,96490216
1,1,1409,-37.8661,144.9772,430000,2248000,1210519424,1818000,1210089424
1,1,0,-37.8599,144.9766,392000,835500,96987232,443500,96595232
4,2,507,-37.8616,144.9807,1900000,2248000,503363328,348000,501463328
2,1,0,-37.8653,144.9824,540000,835500,98357664,295500,97817664
2,1,0,-37.8604,144.9817,475000,835500,98356656,360500,97881656
2,2,0,-37.8709,144.9807,570000,835500,99950536,265500,99380536
2,1,0,-37.8619,144.976,400000,835500,98353320,435500,97953320
3,2,124,-37.8656,144.9851,920000,2248000,199315888,1328000,198395888
2,1,683,-37.8594,144.9828,503500,2248000,638131264,1744500,637627764
2,1,0,-37.8617,144.9796,580000,835500,98355512,255500,97775512
3,2,0,-37.8584,144.9802,1295000,835500,101314968,-459500,100019968
2,1,0,-37.8596,144.9889,481000,835500,98360992,354500,97879992
3,2,1039,-37.8638,144.982,1120000,2248000,922437120,1128000,921317120
1,1,0,-37.8676,144.9901,400000,835500,96996456,435500,96596456
1,1,0,-37.8716,144.9828,1210000,835500,96992432,-374500,95782432
2,2,0,-37.8647,144.9819,785000,835500,99950544,50500,99165544
1,1,0,-37.8731,144.9799,450000,835500,96990824,385500,96540824
2,1,123,-37.8641,144.9866,875000,2248000,195566832,1373000,194691832
2,1,822,-37.8585,144.9854,650000,2248000,747984320,1598000,747334320
2,1,0,-37.8665,144.9833,431000,835500,98358344,404500,97927344
2,1,0,-37.8648,144.9783,385000,835500,98355072,450500,97970072
2,2,0,-37.8562,144.9844,575000,835500,99951096,260500,99376096
5,4,657,-37.8582,144.9913,4400000,2248000,626467008,-2152000,622067008
2,1,0,-37.8614,144.9793,535000,835500,98355280,300500,97820280
2,1,201,-37.8654,144.9809,1200500,2248000,257206816,1047500,256006316
2,2,0,-37.8562,144.9844,565000,835500,99951096,270500,99386096
2,1,1235,-37.8645,144.9749,520000,2248000,1074372096,1728000,1073852096
2,1,0,-37.8681,144.9894,902000,835500,98362288,-66500,97460288
3,2,0,-37.8584,144.9802,1600000,835500,101314968,-764500,99714968
2,2,0,-37.8686,144.9812,750000,835500,99950576,85500,99200576
2,1,361,-37.8646,144.98,1365000,2248000,383653920,883000,382288920
4,2,436,-37.8629,144.9887,1950000,2248000,447257184,298000,445307184
3,2,361,-37.8663,144.9882,1678000,2248000,386618688,570000,384940688
2,1,797,-37.8642,144.9793,400000,2248000,728223744,1848000,727823744
2,2,0,-37.859,144.9767,500000,835500,99946688,335500,99446688
2,1,0,-37.8718,144.9776,760000,835500,98355464,75500,97595464
2,1,1155,-37.8568,144.9873,580000,2248000,1011154880,1668000,1010574880
2,1,0,-37.859,144.9767,430000,835500,98353400,405500,97923400
2,1,1458,-37.8695,144.9763,1100000,2248000,1250610048,1148000,1249510048
1,1,0,-37.8573,144.9825,435000,835500,96990560,400500,96555560
1,1,1659,-37.8699,144.9764,354000,2248000,1408093952,1894000,1407739952
3,2,654,-37.7369,144.9251,1025000,2248000,618122176,1223000,617097176
3,1,694,-37.7411,144.9262,1430000,2248000,648142016,818000,646712016
3,2,606,-37.7378,144.9168,1330000,2248000,580182784,918000,578852784
4,2,0,-37.7354,144.9128,1635000,835500,102625240,-799500,100990240
3,1,650,-37.7436,144.9308,1194000,2248000,613372032,1054000,612178032
5,3,617,-37.7386,144.917,1440000,2248000,593201984,808000,591761984
4,3,0,-37.7337,144.9184,1300000,835500,104221760,-464500,102921760
3,3,250,-37.7189,144.9036,850000,2248000,300419360,1398000,299569360
3,2,696,-37.7261,144.9171,1150000,2248000,651308544,1098000,650158544
3,1,692,-37.7217,144.9074,910000,2248000,646547584,1338000,645637584
4,2,607,-37.7376,144.9154,1430000,2248000,582338496,818000,580908496
3,2,254,-37.7302,144.9167,622500,2248000,301996736,1625500,301374236
3,2,722,-37.7427,144.9226,1500000,2248000,671861696,748000,670361696
4,2,689,-37.7345,144.9196,1280000,2248000,647145216,968000,645865216
5,2,502,-37.7317,144.9177,1485000,2248000,500723968,763000,499238968
3,2,211,-37.734,144.9145,1080000,2248000,268012960,1168000,266932960
4,3,650,-37.7363,144.9208,1715000,2248000,617917760,533000,616202760
5,3,755,-37.7417,144.9133,2650000,2248000,702261312,-402000,699611312
2,2,378,-37.7245,144.9097,630000,2248000,398622560,1618000,397992560
4,2,908,-37.735,144.9203,1370000,2248000,820221056,878000,818851056
3,2,655,-37.7809,144.8424,800000,2248000,618866752,1448000,618066752
3,1,700,-37.7933,144.8411,950000,2248000,652837504,1298000,651887504
3,1,486,-37.7886,144.8438,780000,2248000,483714752,1468000,482934752
4,1,726,-37.7864,144.8353,1350500,2248000,674747136,897500,673396636
3,1,518,-37.7802,144.8374,745000,2248000,508999392,1503000,508254392
3,1,513,-37.7796,144.8372,657500,2248000,505047712,1590500,504390212
4,2,803,-37.7932,144.8434,1030000,2248000,737199232,1218000,736169232
3,2,119,-37.7939,144.8261,460000,2248000,195258064,1788000,194798064
3,1,301,-37.7793,144.8427,490000,2248000,337507712,1758000,337017712
4,1,668,-37.7796,144.845,890000,2248000,628915008,1358000,628025008
2,1,225,-37.7795,144.8432,425000,2248000,276079136,1823000,275654136
3,1,558,-37.7807,144.8341,715000,2248000,540609344,1533000,539894344
3,1,511,-37.7906,144.8387,816000,2248000,503469280,1432000,502653280
2,1,153,-37.7912,144.8439,425500,2248000,219179424,1822500,218753924
3,1,705,-37.8005,144.822,610000,2248000,656778112,1638000,656168112
3,1,0,-37.7796,144.8455,600000,835500,99629528,235500,99029528
2,1,204,-37.7938,144.8321,611000,2248000,259477696,1637000,258866696
4,1,603,-37.7945,144.8267,670000,2248000,577536064,1578000,576866064
3,1,462,-37.7969,144.8276,605000,2248000,464738592,1643000,464133592
4,2,504,-37.7952,144.8325,930000,2248000,500893408,1318000,499963408
3,1,463,-37.7905,144.8359,880000,2248000,465533248,1368000,464653248
3,1,535,-37.7956,144.8292,570000,2248000,522431200,1678000,521861200
3,1,505,-37.7817,144.8448,700000,2248000,498730208,1548000,498030208
3,1,459,-37.7813,144.8394,625000,2248000,462373088,1623000,461748088
3,1,616,-37.7842,144.843,695000,2248000,586452544,1553000,585757544
3,2,653,-37.7815,144.8423,910000,2248000,617286208,1338000,616376208
3,1,563,-37.7956,144.826,607000,2248000,544557632,1641000,543950632
3,1,351,-37.7843,144.8392,679500,2248000,377021088,1568500,376341588
3,1,224,-37.7863,144.8401,500000,2248000,276653920,1748000,276153920
4,2,430,-37.7939,144.8283,895000,2248000,442408544,1353000,441513544
2,2,204,-37.7982,144.823,410000,2248000,261065904,1838000,260655904
3,1,631,-37.7836,144.8408,635000,2248000,598305664,1613000,597670664
3,1,546,-37.7555,144.8295,480000,2248000,531120000,1768000,530640000
2,1,343,-37.7689,144.8402,435000,2248000,369331296,1813000,368896296
2,1,615,-37.7683,144.8316,560000,2248000,584287168,1688000,583727168
4,1,581,-37.7712,144.8336,626800,2248000,560150976,1621200,559524176
3,2,528,-37.758,144.8256,571500,2248000,518485792,1676500,517914292
5,2,661,-37.7651,144.8241,605000,2248000,626327808,1643000,625722808
3,1,751,-37.7692,144.8246,600000,2248000,693129856,1648000,692529856
3,1,598,-37.7705,144.8307,650000,2248000,572218048,1598000,571568048
4,1,615,-37.7675,144.8414,736000,2248000,587025536,1512000,586289536
4,2,635,-37.7693,144.8351,735000,2248000,604421056,1513000,603686056
3,1,538,-37.7704,144.8384,700000,2248000,524804768,1548000,524104768
2,1,968,-37.7698,144.8362,1190000,2248000,863265728,1058000,862075728
3,1,673,-37.7623,144.8272,591000,2248000,631487360,1657000,630896360
3,1,707,-37.7676,144.8339,665000,2248000,658362240,1583000,657697240
3,3,221,-37.7708,144.8401,620000,2248000,277467744,1628000,276847744
3,1,251,-37.7682,144.8335,503000,2248000,297985792,1745000,297482792
5,2,786,-37.7743,144.8425,1000000,2248000,725127552,1248000,724127552
3,1,582,-37.7906,144.7929,560000,2248000,559552320,1688000,558992320
3,2,667,-37.7969,144.8086,615000,2248000,628331392,1633000,627716392
3,3,344,-37.7967,144.8083,450000,2248000,374658016,1798000,374208016
3,1,726,-37.7905,144.8073,680000,2248000,673364160,1568000,672684160
3,1,699,-37.7905,144.8033,620000,2248000,652023680,1628000,651403680
3,2,240,-37.7891,144.8152,545000,2248000,290876992,1703000,290331992
5,2,596,-37.7981,144.7936,621000,2248000,574943552,1627000,574322552
3,1,695,-37.7853,144.8114,687000,2248000,648866816,1561000,648179816
3,4,482,-37.7904,144.8133,485000,2248000,485314848,1763000,484829848
4,1,672,-37.7871,144.8083,510000,2248000,632054528,1738000,631544528
3,1,541,-37.7928,144.804,500000,2248000,527157184,1748000,526657184
3,1,696,-37.7836,144.7988,480000,2248000,649649216,1768000,649169216
4,1,700,-37.7902,144.8102,621000,2248000,654184384,1627000,653563384
3,1,540,-37.789,144.8195,690000,2248000,526375936,1558000,525685936
3,1,603,-37.7891,144.823,547500,2248000,576166976,1700500,575619476
1,1,0,-37.7913,144.7889,280000,835500,96863640,555500,96583640
3,1,836,-37.8003,144.8097,555000,2248000,760299776,1693000,759744776
3,2,579,-37.7968,144.7991,600000,2248000,558779200,1648000,558179200
3,1,534,-37.7887,144.8231,622500,2248000,521636352,1625500,521013852
2,1,235,-37.7847,144.8146,350000,2248000,283965088,1898000,283615088
4,2,651,-37.7914,144.7918,657000,2248000,617041856,1591000,616384856
3,1,694,-37.7894,144.8027,682000,2248000,648071744,1566000,647389744
3,1,691,-37.7886,144.8138,520000,2248000,645707520,1728000,645187520
3,1,591,-37.7987,144.8196,470000,2248000,566682496,1778000,566212496
3,1,701,-37.7843,144.8052,586000,2248000,653604672,1662000,653018672
3,1,367,-37.8018,144.8246,305000,2248000,389658944,1943000,389353944
4,2,759,-37.7951,144.8213,705000,2248000,702412672,1543000,701707672
4,2,616,-37.7904,144.7999,645000,2248000,589386240,1603000,588741240
3,1,627,-37.8023,144.8227,500000,2248000,595135488,1748000,594635488
3,2,333,-37.7912,144.8215,510000,2248000,364378848,1738000,363868848
3,2,805,-37.7966,144.7928,750500,2248000,737382976,1497500,736632476
3,1,655,-37.8022,144.8235,451000,2248000,617264256,1797000,616813256
4,3,596,-37.8154,145.0927,2440000,2248000,575356672,-192000,572916672
3,2,401,-37.8332,145.1105,1110000,2248000,418302016,1138000,417192016
4,3,771,-37.8239,145.0969,2128000,2248000,713662656,120000,711534656
5,3,735,-37.8175,145.0987,2200000,2248000,686578368,48000,684378368
2,1,0,-37.8356,145.1029,640000,835500,98428344,195500,97788344
3,1,763,-37.8148,145.0965,1700000,2248000,702786112,548000,701086112
4,2,783,-37.8181,145.0913,2500000,2248000,721548736,-252000,719048736
4,2,734,-37.8286,145.092,2200000,2248000,682825792,48000,680625792
4,2,779,-37.8185,145.0878,2860000,2248000,718385472,-612000,715525472
4,2,867,-37.8346,145.1059,1930000,2248000,787944832,318000,786014832
4,2,715,-37.8325,145.1114,1812500,2248000,667822528,435500,666010028
2,1,681,-37.8159,145.091,760000,2248000,636612160,1488000,635852160
4,2,809,-37.8337,145.1118,1300000,2248000,742110912,948000,740810912
3,2,585,-37.8167,145.0924,1960000,2248000,563703936,288000,561743936
5,3,777,-37.8287,145.1054,2630000,2248000,719776384,-382000,717146384
3,1,217,-37.8287,145.1014,880000,2248000,271287648,1368000,270407648
3,2,808,-37.832,145.11,1755000,2248000,739953216,493000,738198216
4,1,579,-37.8224,145.0959,1700000,2248000,558737856,548000,557037856
5,2,641,-37.8354,145.1001,1975000,2248000,610700032,273000,608725032
2,1,102,-37.8288,145.1048,610000,2248000,179039168,1638000,178429168
4,2,612,-37.8345,145.1009,1850000,2248000,586415552,398000,584565552
4,2,949,-37.8188,145.0984,2050000,2248000,852742784,198000,850692784
5,2,1025,-37.8286,145.1094,2100000,2248000,914179648,148000,912079648
3,2,247,-37.836,145.1046,1150000,2248000,296592704,1098000,295442704
2,2,88,-37.819,145.0888,770500,2248000,169557280,1477500,168786780
2,1,101,-37.8263,145.0962,600000,2248000,178243280,1648000,177643280
4,2,702,-37.8345,145.095,2125000,2248000,657538816,123000,655413816
2,1,951,-37.8261,145.0902,656000,2248000,849993472,1592000,849337472
5,2,632,-37.8352,145.1023,1518000,2248000,603588608,730000,602070608
3,2,335,-37.8165,145.0981,1560000,2248000,366132704,688000,364572704
3,1,217,-37.8275,145.1032,865000,2248000,271288608,1383000,270423608
4,3,1064,-37.8324,145.1018,2160000,2248000,945224128,88000,943064128
3,2,735,-37.8182,145.096,2300000,2248000,682251072,-52000,679951072
2,1,124,-37.8159,145.0902,600000,2248000,196415248,1648000,195815248
3,1,441,-37.8204,145.0887,2180000,2248000,448305760,68000,446125760
3,2,536,-37.8309,145.0946,1251000,2248000,524982304,997000,523731304
6,3,713,-37.8328,145.104,1650000,2248000,670563072,598000,668913072
4,2,619,-37.8171,145.0934,1835000,2248000,591940992,413000,590105992
2,1,170,-37.8186,145.0892,778500,2248000,232768704,1469500,231990204
4,2,657,-37.7624,145.1175,1201000,2248000,621980672,1047000,620779672
4,2,673,-37.7647,145.1246,1165000,2248000,634630080,1083000,633465080
3,1,313,-37.7556,145.0946,742500,2248000,347143552,1505500,346401052
3,2,643,-37.7602,145.1166,1101000,2248000,609549440,1147000,608448440
3,1,730,-37.76,145.1054,1200000,2248000,676705280,1048000,675505280
4,2,652,-37.7573,145.0994,990000,2248000,618017472,1258000,617027472
4,2,420,-37.767,145.119,1500000,2248000,434681344,748000,433181344
3,1,900,-37.764,145.1097,1290000,2248000,811059200,958000,809769200
4,2,671,-37.7631,145.1108,790000,2248000,633040832,1458000,632250832
5,3,700,-37.7658,145.124,950000,2248000,658927424,1298000,657977424
4,2,650,-37.7694,145.1222,1421000,2248000,616452288,827000,615031288
3,2,962,-37.7644,145.112,1051000,2248000,861652416,1197000,860601416
5,2,666,-37.7692,145.1253,1710000,2248000,630465216,538000,628755216
4,2,681,-37.7646,145.1167,1280000,2248000,640947648,968000,639667648
5,3,800,-37.7696,145.1078,750000,2248000,737947776,1498000,737197776
4,3,728,-37.768,145.1027,1000000,2248000,679676800,1248000,678676800
2,1,340,-37.7564,145.1195,678000,2248000,367130848,1570000,366452848
3,2,751,-37.77,145.1025,1010000,2248000,694894272,1238000,693884272
3,1,794,-37.7569,145.1179,1210000,2248000,727291776,1038000,726081776
4,2,675,-37.764,145.1145,945000,2248000,636204480,1303000,635259480
3,1,465,-37.7549,145.1185,725000,2248000,467283616,1523000,466558616
3,2,875,-37.767,145.1097,1211000,2248000,792895360,1037000,791684360
4,2,654,-37.7639,145.1145,1100000,2248000,619608192,1148000,618508192
3,1,799,-37.7698,145.1028,1002000,2248000,731235456,1246000,730233456
4,2,770,-37.7617,145.1065,1209000,2248000,711277568,1039000,710068568
5,4,646,-37.7625,145.1043,2080000,2248000,617832064,168000,615752064
4,2,705,-37.7595,145.1176,1118000,2248000,659914752,1130000,658796752
4,1,618,-37.7564,145.1043,903000,2248000,589556928,1345000,588653928
3,1,720,-37.7668,145.1086,1220000,2248000,668805120,1028000,667585120
4,2,673,-37.7647,145.1186,1650000,2248000,634626432,598000,632976432
4,2,650,-37.7764,145.1216,1182500,2248000,616452736,1065500,615270236
4,2,652,-37.7557,145.0957,1020000,2248000,618015040,1228000,616995040
3,1,327,-37.7709,145.1104,650000,2248000,358219264,1598000,357569264
3,2,812,-37.7714,145.1141,1509000,2248000,743109760,739000,741600760
1,1,0,-37.762,144.996,517500,835500,96987680,318000,96470180
1,1,0,-37.7634,145.021,370000,835500,97003224,465500,96633224
2,1,164,-37.7536,144.9825,805000,2248000,227953568,1443000,227148568
4,2,470,-37.7601,145.0122,1428888,2248000,474129760,819112,472700872
2,1,372,-37.7631,145.0091,940000,2248000,392353184,1308000,391413184
1,1,0,-37.7581,144.9944,270000,835500,96986232,565500,96716232
1,1,0,-37.7544,145.0092,365000,835500,96994912,470500,96629912
2,1,724,-37.7564,145.0026,525500,2248000,670533696,1722500,670008196
2,1,185,-37.763,145.0025,944000,2248000,244563280,1304000,243619280
3,2,540,-37.7554,145.0211,887000,2248000,528089376,1361000,527202376
3,3,273,-37.7583,145.0174,701000,2248000,318670944,1547000,317969944
2,1,288,-37.7564,144.9971,1110000,2248000,325959968,1138000,324849968
1,1,612,-37.7603,145.0165,332000,2248000,580663040,1916000,580331040
3,2,397,-37.7515,144.9857,1265000,2248000,415054432,983000,413789432
2,1,303,-37.7569,144.9914,1085000,2248000,337810976,1163000,336725976
3,2,210,-37.7551,144.9993,898000,2248000,267277328,1350000,266379328
3,3,288,-37.7583,145.0025,1235000,2248000,330516256,1013000,329281256
3,2,157,-37.759,144.988,910500,2248000,225384992,1337500,224474492
3,1,327,-37.7574,144.9854,995000,2248000,358140736,1253000,357145736
2,1,0,-37.7595,145.0061,760000,835500,98359816,75500,97599816
2,1,0,-37.7591,145.0211,505000,835500,98369000,330500,97864000
3,2,417,-37.7595,145.0017,1400000,2248000,430871168,848000,429471168
3,1,562,-37.7602,144.9878,1110000,2248000,543862720,1138000,542752720
3,2,345,-37.7582,145.0094,1200000,2248000,373974240,1048000,372774240
2,1,0,-37.7526,145.0023,450000,835500,98356664,385500,97906664
2,1,333,-37.7642,145.0192,874000,2248000,361537920,1374000,360663920
3,1,275,-37.7592,145.0105,1427000,2248000,317060832,821000,315633832
1,1,0,-37.7539,145.0075,383000,835500,96993808,452500,96610808
3,1,435,-37.7607,145.0105,1290000,2248000,443508864,958000,442218864
2,1,335,-37.7516,144.9871,450000,2248000,363097280,1798000,362647280
2,1,0,-37.7541,145.0088,438000,835500,98360848,397500,97922848
3,2,297,-37.7617,145.0117,1250000,2248000,336041728,998000,334791728
3,2,158,-37.7588,144.9881,1070000,2248000,226175344,1178000,225105344
3,2,377,-37.7578,145.0076,1570000,2248000,399262688,678000,397692688
2,1,0,-37.761,145.0055,486000,835500,98359616,349500,97873616
2,1,302,-37.7549,145.0035,1211000,2248000,337027872,1037000,335816872
3,1,253,-37.7566,144.9965,1280000,2248000,299665376,968000,298385376
4,2,387,-37.7569,145.0041,1478000,2248000,408529632,770000,407051632
3,2,611,-37.7575,144.9968,1913000,2248000,584185856,335000,582272856
4,2,538,-37.7595,145.0241,928500,2248000,527877248,1319500,526948748
2,1,748,-37.7587,145.0064,432500,2248000,689503424,1815500,689070924
1,1,0,-37.7544,145.0092,330000,835500,96994912,505500,96664912
3,2,417,-37.7602,145.0084,1370000,2248000,430875392,878000,429505392
1,1,0,-37.7542,145.01,303500,835500,96995368,532000,96691868
3,2,644,-37.7604,145.021,1160000,2248000,610281024,1088000,609121024
3,2,359,-37.7565,144.9906,1380000,2248000,385026688,868000,383646688
3,1,889,-37.8328,145.0065,1435000,2248000,802310464,813000,800875464
4,3,691,-37.8431,145.021,5500000,2248000,650394240,-3252000,644894240
4,4,877,-37.8447,145.0134,5500000,2248000,798978624,-3252000,793478624
3,1,222,-37.8448,145.0055,1689000,2248000,275182016,559000,273493016
3,2,0,-37.8429,145.0227,1100000,835500,101339312,-264500,100239312
2,2,0,-37.8371,145.0066,925000,835500,99962512,-89500,99037512
2,1,0,-37.8474,145.0078,450000,835500,98371176,385500,97921176
1,1,0,-37.8369,145.0077,349000,835500,97003688,486500,96654688
3,3,0,-37.8428,145.0171,2650000,835500,102929128,-1814500,100279128
3,2,600,-37.8332,145.0117,2820000,2248000,575510656,-572000,572690656
2,2,0,-37.842,145.0046,810000,835500,99961856,25500,99151856
3,2,1317,-37.838,145.0054,2840000,2248000,1142151680,-592000,1139311680
3,2,294,-37.8503,145.0292,2700000,2248000,333692000,-452000,330992000
3,3,564,-37.8486,145.0244,6250000,2248000,548662784,-4002000,542412784
4,3,732,-37.8349,145.01,4500000,2248000,682788736,-2252000,678288736
1,1,0,-37.8373,145.0116,541000,835500,97006128,294500,96465128
3,2,117,-37.8343,145.0112,1550000,2248000,193796160,698000,192246160
3,2,0,-37.8512,145.0282,2205000,835500,101343672,-1369500,99138672
3,1,57,-37.8371,145.012,950000,2248000,144785776,1298000,143835776
1,1,0,-37.8464,145.0074,366000,835500,97004608,469500,96638608
4,2,516,-37.8398,145.0305,2620000,2248000,510504096,-372000,507884096
3,2,268,-37.8369,145.0072,1900000,2248000,313129120,348000,311229120
4,2,684,-37.8485,145.0169,4000000,2248000,643267008,-1752000,639267008
3,4,565,-37.8448,145.0123,4200000,2248000,551038464,-1952000,546838464
2,1,0,-37.8416,145.0313,690000,835500,98384968,145500,97694968
2,1,0,-37.8424,145.0184,511000,835500,98377120,324500,97866120
3,2,0,-37.842,145.0046,910000,835500,101328056,-74500,100418056
3,3,575,-37.8375,145.0092,2250000,2248000,557345408,-2000,555095408
2,1,0,-37.8424,145.0184,525000,835500,98377128,310500,97852128
3,2,363,-37.8445,145.0182,3270000,2248000,388215200,-1022000,384945200
3,2,656,-37.7322,145.0995,960000,2248000,619809536,1288000,618849536
4,3,669,-37.7419,145.083,1010000,2248000,633033856,1238000,632023856
3,2,704,-37.7327,145.0913,880000,2248000,657738880,1368000,656858880
3,2,577,-37.7376,145.0895,770000,2248000,557370432,1478000,556600432
4,1,865,-37.7297,145.0946,730000,2248000,784751552,1518000,784021552
4,2,696,-37.7395,145.0875,1005000,2248000,652781184,1243000,651776184
2,1,197,-37.7393,145.0806,555000,2248000,254092144,1693000,253537144
2,1,177,-37.7388,145.081,546000,2248000,238286368,1702000,237740368
3,1,608,-37.7396,145.0885,765000,2248000,580276032,1483000,579511032
3,2,834,-37.7396,145.0884,920000,2248000,760476800,1328000,759556800
5,3,531,-37.7378,145.0955,1025000,2248000,525346080,1223000,524321080
4,2,700,-37.7326,145.0881,895000,2248000,655941952,1353000,655046952
3,2,628,-37.7314,145.0941,820000,2248000,597677760,1428000,596857760
3,1,698,-37.7343,145.0837,870000,2248000,651399360,1378000,650529360
4,2,660,-37.7375,145.0917,1050000,2248000,624332800,1198000,623282800
3,1,583,-37.7137,145.0778,660000,2248000,560508928,1588000,559848928
3,2,567,-37.7148,145.0851,581000,2248000,549462016,1667000,548881016
3,1,605,-37.7166,145.0837,600000,2248000,577899520,1648000,577299520
3,2,308,-37.7078,145.0807,690000,2248000,344771136,1558000,344081136
3,1,302,-37.7163,145.0768,582000,2248000,338434688,1666000,337852688
3,1,591,-37.7135,145.0783,740000,2248000,566831616,1508000,566091616
3,2,280,-37.7153,145.0854,671000,2248000,322646528,1577000,321975528
3,1,671,-37.7072,145.0855,741000,2248000,630059200,1507000,629318200
3,1,327,-37.7125,145.0768,537000,2248000,358191712,1711000,357654712
3,2,903,-37.7085,145.0824,1040000,2248000,815000064,1208000,813960064
4,3,670,-37.7122,145.0765,1171000,2248000,633816768,1077000,632645768
2,1,605,-37.7118,145.088,662000,2248000,576535360,1586000,575873360
3,1,798,-37.7112,145.0869,922000,2248000,730428480,1326000,729506480
3,2,767,-37.7084,145.0788,860500,2248000,707517184,1387500,706656684
3,1,604,-37.7115,145.088,702000,2248000,577111296,1546000,576409296
3,1,319,-37.7165,145.0759,627500,2248000,351869248,1620500,351241748
3,1,0,-37.7141,145.0754,549000,835500,99763320,286500,99214320
2,1,762,-37.7112,145.0861,701000,2248000,700611072,1547000,699910072
3,1,355,-37.7065,145.0825,645000,2248000,380322880,1603000,379677880
3,3,0,-37.8048,144.9424,1010000,835500,102878688,-174500,101868688
3,3,506,-37.805,144.9448,1260000,2248000,502771360,988000,501511360
1,1,0,-37.8076,144.9456,460000,835500,96962016,375500,96502016
3,3,265,-37.8073,144.9481,2370000,2248000,312311616,-122000,309941616
2,2,54,-37.8094,144.9479,800000,2248000,142599248,1448000,141799248
1,1,0,-37.8076,144.9456,550000,835500,96962016,285500,96412016
3,2,0,-37.8118,144.9526,660000,835500,101292512,175500,100632512
2,1,0,-37.8094,144.9452,1055000,835500,98328192,-219500,97273192
3,1,0,-37.8076,144.9474,995000,835500,99695536,-159500,98700536
1,1,547,-37.806,144.942,443000,2248000,529253024,1805000,528810024
3,3,801,-37.8067,144.9435,1120000,2248000,735908928,1128000,734788928
1,1,0,-37.8076,144.9456,482000,835500,96962016,353500,96480016
2,1,0,-37.8091,144.952,620000,835500,98332336,215500,97712336
3,1,0,-37.8118,144.9526,601000,835500,99699240,234500,99098240
4,2,320,-37.8613,144.8988,1400000,2248000,355527008,848000,354127008
3,1,507,-37.8681,144.8994,1535000,2248000,500354624,713000,498819624
3,1,0,-37.8663,144.8883,890000,835500,99666056,-54500,98776056
3,2,332,-37.8652,144.9019,1800000,2248000,363646752,448000,361846752
4,3,338,-37.8633,144.8963,2910000,2248000,371344352,-662000,368434352
3,3,515,-37.8609,144.8947,2910000,2248000,509859776,-662000,506949776
3,2,315,-37.8595,144.8868,1200000,2248000,350201728,1048000,349001728
3,1,373,-37.8661,144.8973,1460000,2248000,394452992,788000,392992992
1,1,0,-37.8588,144.8919,310000,835500,96934984,525500,96624984
3,2,348,-37.8578,144.8799,1200000,2248000,376277120,1048000,375077120
3,2,310,-37.8644,144.9039,1560000,2248000,346261344,688000,344701344
3,2,430,-37.8613,144.8939,1575000,2248000,441090688,673000,439515688
2,1,84,-37.8581,144.9015,830000,2248000,164692112,1418000,163862112
3,2,364,-37.8513,144.8961,1470000,2248000,388931104,778000,387461104
4,2,782,-37.8647,144.8867,2230000,2248000,720638016,18000,718408016
3,2,506,-37.8658,144.8857,1460000,2248000,501148864,788000,499688864
4,3,217,-37.8634,144.8796,1330000,2248000,275707936,918000,274377936
3,2,418,-37.8571,144.8767,1010000,2248000,431596000,1238000,430586000
2,1,0,-37.8536,144.8981,513500,835500,98304400,322000,97790900
4,2,466,-37.8621,144.8872,1805000,2248000,470903616,443000,469098616
4,1,307,-37.8525,144.8945,1126000,2248000,343656192,1122000,342530192
3,2,233,-37.8573,144.8911,935000,2248000,285399616,1313000,284464616
2,1,0,-37.8504,144.8924,375000,835500,98300512,460500,97925512
4,2,648,-37.8601,144.8879,2050000,2248000,614738176,198000,612688176
3,2,185,-37.8664,144.9072,1310000,2248000,247476240,938000,246166240
2,1,0,-37.8563,144.8995,491500,835500,98305576,344000,97814076
2,1,0,-37.8612,144.8971,547500,835500,98304672,288000,97757172
3,1,249,-37.86,144.895,1210000,2248000,296453824,1038000,295243824
2,1,0,-37.8586,144.8937,412000,835500,98302272,423500,97890272
4,2,265,-37.8656,144.9039,1630000,2248000,312064224,618000,310434224
3,2,506,-37.8592,144.888,1482500,2248000,501149472,765500,499666972
4,2,369,-37.8576,144.8992,1300000,2248000,394251488,948000,392951488
4,1,765,-37.8621,144.8999,2255000,2248000,705617472,-7000,703362472
3,2,260,-37.8671,144.9001,1710000,2248000,306744384,538000,305034384
4,3,500,-37.8638,144.8798,2440000,2248000,499362720,-192000,496922720
2,1,0,-37.8564,144.8864,380000,835500,98297520,455500,97917520
2,1,0,-37.8571,144.8841,367500,835500,98296184,468000,97928684
3,1,311,-37.8546,144.8762,1225000,2248000,345440128,1023000,344215128
2,2,0,-37.8558,144.9903,580000,835500,99954680,255500,99374680
3,1,440,-37.8528,144.9994,2302000,2248000,447464320,-54000,445162320
2,1,598,-37.8564,144.9971,611000,2248000,570964288,1637000,570353288
2,1,0,-37.8577,145.0002,800000,835500,98367712,35500,97567712
1,1,0,-37.8564,145.0016,275000,835500,97002224,560500,96727224
3,2,138,-37.8556,144.995,1540000,2248000,210384960,708000,208844960
3,1,317,-37.856,144.9891,1370000,2248000,350251584,878000,348881584
1,1,0,-37.8568,145.0004,452000,835500,97001520,383500,96549520
1,1,0,-37.8571,144.9979,501000,835500,97000016,334500,96499016
2,1,0,-37.8555,145.0018,380000,835500,98368448,455500,97988448
2,2,521,-37.8543,144.9939,1177000,2248000,511702400,1071000,510525400
2,1,0,-37.8559,144.999,600000,835500,98366768,235500,97766768
2,1,0,-37.8518,144.9868,1500000,835500,98358792,-664500,96858792
3,2,0,-37.8526,144.9977,830000,835500,101325064,5500,100495064
2,2,0,-37.8563,144.9916,1200000,835500,99955536,-364500,98755536
2,1,1452,-37.8554,145.0018,600000,2248000,1245882240,1648000,1245282240
2,1,0,-37.8552,145.0005,474000,835500,98367616,361500,97893616
2,1,157,-37.8522,144.986,1350000,2248000,222435232,898000,221085232
3,3,143,-37.8525,144.9881,1910000,2248000,215925136,338000,214015136
4,3,531,-37.7198,145.1034,915000,2248000,523982688,1333000,523067688
3,2,568,-37.7216,145.1066,810000,2248000,550266368,1438000,549456368
3,2,536,-37.7233,145.1045,753000,2248000,524975776,1495000,524222776
3,2,586,-37.7279,145.1017,602500,2248000,564489600,1645500,563887100
3,1,614,-37.7305,145.081,742000,2248000,585012160,1506000,584270160
4,2,551,-37.7302,145.0883,953000,2248000,538187264,1295000,537234264
3,1,706,-37.731,145.0811,650000,2248000,657719744,1598000,657069744
3,2,566,-37.7195,145.1034,731000,2248000,548683584,1517000,547952584
3,1,616,-37.7306,145.0854,710000,2248000,586595520,1538000,585885520
3,2,587,-37.72,145.1014,936000,2248000,565278720,1312000,564342720
3,1,687,-37.7303,145.0823,721000,2248000,642704768,1527000,641983768
3,2,448,-37.8228,144.8799,1000000,2248000,455302944,1248000,454302944
2,1,471,-37.8149,144.8707,890000,2248000,470513696,1358000,469623696
3,1,191,-37.8175,144.8879,1165000,2248000,250607136,1083000,249442136
4,2,427,-37.8187,144.8771,1550000,2248000,440070656,698000,438520656
3,1,323,-37.8108,144.8899,770000,2248000,354927040,1478000,354157040
3,2,428,-37.8167,144.8965,871000,2248000,439506464,1377000,438635464
3,2,213,-37.8175,144.8964,780000,2248000,269592192,1468000,268812192
2,1,0,-37.8113,144.8955,650000,835500,98297816,185500,97647816
3,1,138,-37.82,144.891,770000,2248000,208723504,1478000,207953504
4,2,244,-37.8139,144.8741,1235000,2248000,295443552,1013000,294208552
2,1,220,-37.8115,144.8875,1000000,2248000,272158656,1248000,271158656
3,2,473,-37.8217,144.8842,1320000,2248000,475062944,928000,473742944
3,2,214,-37.8175,144.8929,1100000,2248000,270380352,1148000,269280352
2,1,1555,-37.8156,144.8943,782000,2248000,1327212160,1466000,1326430160
3,3,197,-37.8197,144.8875,910000,2248000,258535488,1338000,257625488
2,1,261,-37.8157,144.887,856000,2248000,304561120,1392000,303705120
3,1,477,-37.8186,144.8736,670000,2248000,476623968,1578000,475953968
4,1,165,-37.819,144.895,706000,2248000,231430128,1542000,230724128
3,2,462,-37.8128,144.8695,1050000,2248000,466359488,1198000,465309488
4,2,319,-37.8197,144.8957,1320000,2248000,354729952,928000,353409952
5,2,644,-37.8102,144.8857,1815000,2248000,612935936,433000,611120936
2,1,148,-37.822,144.89,630000,2248000,215259920,1618000,214629920
4,1,766,-37.8126,144.8905,1870000,2248000,706396160,378000,704526160
3,1,902,-37.8153,144.8796,1930000,2248000,812504128,318000,810574128
1,1,0,-37.8173,144.894,510000,835500,96931392,325500,96421392
2,1,0,-37.8128,144.8953,381000,835500,98297880,454500,97916880
3,2,352,-37.8164,144.8869,1040000,2248000,379437824,1208000,378397824
1,1,0,-37.8173,144.894,470000,835500,96931392,365500,96461392
2,1,0,-37.8106,144.8957,501344,835500,98297880,334156,97796536
3,1,464,-37.8151,144.8638,796000,2248000,466343552,1452000,465547552
3,1,670,-37.8134,144.8745,1055000,2248000,629151488,1193000,628096488
3,3,0,-37.8194,144.8826,620000,835500,102843592,215500,102223592
1,1,0,-37.8111,144.887,345000,835500,96926352,490500,96581352
3,1,240,-37.8202,144.8896,950000,2248000,289333120,1298000,288383120
4,2,417,-37.8197,144.8969,1200000,2248000,432179936,1048000,430979936
3,1,438,-37.8177,144.8711,1005000,2248000,445800576,1243000,444795576
4,2,297,-37.8108,144.888,1340000,2248000,337337600,908000,335997600
3,1,189,-37.8159,144.8795,865000,2248000,249021184,1383000,248156184
3,1,341,-37.8224,144.8818,781500,2248000,369148768,1466500,368367268
4,1,306,-37.8102,144.8885,1401000,2248000,342857184,847000,341456184
2,2,168,-37.8225,144.8814,630000,2248000,232653920,1618000,232023920
5,3,446,-37.8146,144.8692,1137500,2248000,458040448,1110500,456902948
4,1,411,-37.8117,144.8873,1158000,2248000,425838080,1090000,424680080
3,2,206,-37.8127,144.8965,955000,2248000,264059616,1293000,263104616
3,1,448,-37.8171,144.8753,1081000,2248000,453706144,1167000,452625144
3,1,558,-37.8119,144.868,725000,2248000,540633920,1523000,539908920
2,1,128,-37.8179,144.8908,767000,2248000,199453936,1481000,198686936
3,2,542,-37.811,144.8844,1450000,2248000,529592352,798000,528142352
3,3,386,-37.816,144.8936,1430000,2248000,407905280,818000,406475280
3,1,229,-37.8172,144.8919,1275000,2248000,280640928,973000,279365928
4,2,455,-37.8177,144.8839,1606000,2248000,462203072,642000,460597072
2,1,435,-37.8223,144.8779,780000,2248000,442068256,1468000,441288256
3,1,463,-37.8137,144.8636,670000,2248000,465553024,1578000,464883024
3,2,235,-37.815,144.8928,1380000,2248000,286976320,868000,285596320
2,1,0,-37.8182,144.8846,480500,835500,98291928,355000,97811428
4,2,261,-37.8123,144.8888,1520000,2248000,308887456,728000,307367456
5,2,488,-37.8131,144.8778,1287000,2248000,489644832,961000,488357832
3,2,169,-37.8122,144.8965,800000,2248000,234818512,1448000,234018512
3,1,463,-37.8172,144.8924,1460000,2248000,465571168,788000,464111168
3,1,470,-37.822,144.8904,840000,2248000,471102592,1408000,470262592
3,1,208,-37.8145,144.8804,900500,2248000,264037232,1347500,263136732
3,2,171,-37.8124,144.8957,940000,2248000,236398672,1308000,235458672
1,1,0,-37.7561,144.9028,380000,835500,96929624,455500,96549624
4,3,757,-37.7606,144.8909,1646000,2248000,702464128,602000,700818128
2,1,976,-37.7557,144.9037,470000,2248000,869627968,1778000,869157968
4,2,559,-37.7614,144.8925,1346000,2248000,544392832,902000,543046832
3,2,217,-37.7591,144.8923,935000,2248000,272744064,1313000,271809064
4,4,670,-37.7637,144.8931,3900000,2248000,635303168,-1652000,631403168
4,2,578,-37.7614,144.8953,1150000,2248000,559410240,1098000,558260240
1,2,676,-37.7632,144.898,1720000,2248000,632762752,528000,631042752
2,1,809,-37.7587,144.9015,1705000,2248000,737647040,543000,735942040
3,1,465,-37.7626,144.8954,1190000,2248000,467147200,1058000,465957200
5,3,839,-37.759,144.9015,1740000,2248000,768641280,508000,766901280
4,2,578,-37.7614,144.8953,1200000,2248000,559410240,1048000,558210240
3,1,229,-37.7606,144.8973,726000,2248000,280637568,1522000,279911568
3,3,593,-37.7584,144.8968,1300000,2248000,571492352,948000,570192352
2,1,0,-37.76,144.9002,670000,835500,98294696,165500,97624696
4,2,1076,-37.7609,144.8905,1350000,2248000,952976128,898000,951626128
3,1,626,-37.752,145.0367,773000,2248000,594471040,1475000,593698040
3,1,631,-37.7506,145.043,645000,2248000,598426240,1603000,597781240
3,2,231,-37.7527,145.0392,720000,2248000,283897888,1528000,283177888
3,1,609,-37.7504,145.0335,625000,2248000,581033792,1623000,580408792
3,1,456,-37.7638,144.9804,1310000,2248000,460086912,938000,458776912
4,2,136,-37.7601,144.9805,856000,2248000,210150432,1392000,209294432
2,1,0,-37.7668,144.9765,580000,835500,98342448,255500,97762448
3,1,213,-37.7643,144.9808,940000,2248000,268044656,1308000,267104656
3,1,259,-37.7762,144.9755,1495000,2248000,304396544,753000,302901544
4,2,470,-37.7735,144.9833,1550000,2248000,474113568,698000,472563568
4,1,233,-37.7776,144.9727,1815000,2248000,285213376,433000,283398376
4,2,822,-37.7749,144.9762,1625000,2248000,752294528,623000,750669528
3,2,116,-37.7667,144.9821,899000,2248000,192980016,1349000,192081016
2,1,197,-37.7717,144.9719,435000,2248000,254029056,1813000,253594056
2,1,193,-37.7765,144.9751,1080000,2248000,250870400,1168000,249790400
2,1,0,-37.7786,144.9753,656000,835500,98343096,179500,97687096
3,3,336,-37.7664,144.9797,1574000,2248000,368437504,674000,366863504
2,1,0,-37.7786,144.9753,665000,835500,98343096,170500,97678096
2,2,0,-37.7753,144.9725,590000,835500,99934264,245500,99344264
3,2,326,-37.7776,144.9751,1679000,2248000,358939744,569000,357260744
3,3,87,-37.7739,144.975,1050000,2248000,171651104,1198000,170601104
3,1,213,-37.7729,144.9724,825000,2248000,268040496,1423000,267215496
3,1,104,-37.7723,144.9761,998000,2248000,181900112,1250000,180902112
3,2,0,-37.774,144.9731,1010000,835500,101300688,-174500,100290688
3,1,279,-37.7729,144.9722,1050000,2248000,320200064,1198000,319150064
3,1,812,-37.7673,144.9782,1600000,2248000,741432384,648000,739832384
3,2,190,-37.7684,144.9739,1325000,2248000,251457280,923000,250132280
3,1,308,-37.7713,144.9744,1335000,2248000,343119936,913000,341784936
3,1,0,-37.7789,144.9739,805000,835500,99708472,30500,98903472
2,1,225,-37.8285,145.0125,1231010,2248000,276189088,1016990,274958078
2,1,172,-37.8283,145.012,881000,2248000,234302928,1367000,233421928
2,1,149,-37.8287,145.0089,1202500,2248000,216124176,1045500,214921676
3,1,182,-37.8289,145.0089,1435000,2248000,243570272,813000,242135272
3,2,0,-37.8052,144.9604,860000,835500,101296528,-24500,100436528
3,2,100,-37.7983,144.9655,1590000,2248000,180328736,658000,178738736
2,1,0,-37.8009,144.9662,610250,835500,98340112,225250,97729862
2,1,117,-37.793,144.9728,720000,2248000,190808192,1528000,190088192
2,1,66,-37.8049,144.9644,840000,2248000,150499200,1408000,149659200
2,1,0,-37.7969,144.9669,705000,835500,98340080,130500,97635080
4,2,132,-37.801,144.9656,1630100,2248000,206984880,617900,205354780
2,2,0,-37.7929,144.9705,500000,835500,99935104,335500,99435104
2,1,101,-37.7989,144.9713,1010000,2248000,178163200,1238000,177153200
2,1,144,-37.7984,144.9738,1170000,2248000,212147504,1078000,210977504
2,2,0,-37.7969,144.9742,600000,835500,99937840,235500,99337840
4,1,152,-37.7966,144.9709,1616000,2248000,221200320,632000,219584320
2,1,0,-37.7986,144.9682,589000,835500,98341088,246500,97752088
2,1,128,-37.7996,144.9737,1117000,2248000,199502800,1131000,198385800
2,2,0,-37.8127,144.9847,1935000,835500,99946160,-1099500,98011160
2,2,0,-37.8153,144.9842,700000,835500,99946160,135500,99246160
1,1,0,-37.8136,144.9892,750000,835500,96989552,85500,96239552
4,2,505,-37.7518,144.8897,1422000,2248000,501713824,826000,500291824
4,2,740,-37.7517,144.8873,1345000,2248000,687432576,903000,686087576
3,1,556,-37.7537,144.8856,787500,2248000,539057280,1460500,538269780
4,2,179,-37.7527,144.8824,652500,2248000,244072016,1595500,243419516
5,2,616,-37.7497,144.8867,1300000,2248000,590801088,948000,589501088
3,2,0,-37.7532,144.8848,730000,835500,101243896,105500,100513896
7,2,614,-37.75,144.8858,1300000,2248000,591952384,948000,590652384
3,2,356,-37.7493,144.8901,970000,2248000,382593056,1278000,381623056
3,1,688,-37.7577,144.8892,1115000,2248000,643379392,1133000,642264392
2,1,97,-37.7118,144.9689,333000,2248000,174990288,1915000,174657288
3,2,738,-37.7109,144.9654,455000,2248000,684529088,1793000,684074088
2,1,215,-37.7049,144.9638,378000,2248000,268241616,1870000,267863616
3,1,605,-37.6985,144.9615,585000,2248000,577822144,1663000,577237144
3,1,650,-37.7076,144.9753,615000,2248000,613395200,1633000,612780200
3,1,404,-37.7075,144.9678,526000,2248000,418977088,1722000,418451088
3,1,614,-37.7141,144.9677,540000,2248000,584940480,1708000,584400480
4,2,254,-37.7082,144.9725,540000,2248000,303394688,1708000,302854688
3,1,585,-37.695,144.9676,625000,2248000,562019520,1623000,561394520
3,2,587,-37.6996,144.9605,681000,2248000,565189568,1567000,564508568
3,1,720,-37.7043,144.9769,640000,2248000,668716608,1608000,668076608
3,2,603,-37.7194,144.9678,783000,2248000,577841216,1465000,577058216
4,2,567,-37.7102,144.9703,635000,2248000,550757056,1613000,550122056
2,1,640,-37.7038,144.9638,619000,2248000,604118400,1629000,603499400
3,1,314,-37.7066,144.9733,460000,2248000,347853440,1788000,347393440
3,6,592,-37.712,144.9719,751000,2248000,575522624,1497000,574771624
3,1,528,-37.6989,144.9779,609000,2248000,516979296,1639000,516370296
4,1,0,-37.7106,144.9682,752500,835500,101063160,83000,100310660
3,1,602,-37.7144,144.9737,650000,2248000,575460608,1598000,574810608
4,2,613,-37.7034,144.9666,750000,2248000,587107776,1498000,586357776
3,1,609,-37.7083,144.9644,527000,2248000,580986240,1721000,580459240
3,1,599,-37.7071,144.9666,515000,2248000,573084480,1733000,572569480
3,1,540,-37.6973,144.962,617000,2248000,526452928,1631000,525835928
4,2,209,-37.7172,144.968,540000,2248000,267829504,1708000,267289504
3,2,297,-37.6994,144.9686,631000,2248000,336007872,1617000,335376872
3,1,533,-37.6985,144.9778,640000,2248000,520930624,1608000,520290624
2,1,621,-37.7164,144.9666,575000,2248000,589105984,1673000,588530984
4,2,374,-37.7056,144.9671,562000,2248000,398226912,1686000,397664912
3,1,604,-37.6978,144.9686,620000,2248000,577036096,1628000,576416096
3,1,592,-37.6968,144.9674,652500,2248000,567551680,1595500,566899180
4,2,607,-37.716,144.9663,1010000,2248000,582367232,1238000,581357232
3,1,208,-37.7092,144.9695,492000,2248000,264079728,1756000,263587728
3,2,195,-37.7062,144.9688,422500,2248000,255398336,1825500,254975836
3,2,431,-37.8269,145.0496,1865000,2248000,441972800,383000,440107800
5,3,431,-37.825,145.0536,1700000,2248000,446300704,548000,444600704
3,2,466,-37.8305,145.0475,1450000,2248000,469632352,798000,468182352
3,2,94,-37.8302,145.0525,1110000,2248000,175644224,1138000,174534224
4,2,640,-37.826,145.0498,3100000,2248000,608511424,-852000,605411424
2,1,0,-37.8318,145.0448,555000,835500,98392128,280500,97837128
3,2,646,-37.8337,145.0469,1700000,2248000,611886144,548000,610186144
2,1,390,-37.8322,145.0486,1585000,2248000,406611040,663000,405026040
3,2,144,-37.8435,145.0497,935000,2248000,215159008,1313000,214224008
2,1,0,-37.8278,145.0565,460000,835500,98398856,375500,97938856
4,1,764,-37.8374,145.0486,2800000,2248000,704915840,-552000,702115840
2,1,0,-37.8254,145.047,573000,835500,98392720,262500,97819720
2,1,0,-37.8233,145.0575,680000,835500,98398936,155500,97718936
5,2,452,-37.8223,145.0494,2250000,2248000,461300832,-2000,459050832
4,2,457,-37.8332,145.0461,2381000,2248000,463885344,-133000,461504344
4,3,324,-37.8348,145.0503,1738000,2248000,360371648,510000,358633648
3,1,0,-37.8414,145.0505,735000,835500,99762976,100500,99027976
3,1,362,-37.8337,145.0504,1420000,2248000,385850176,828000,384430176
2,1,0,-37.8339,145.0548,400000,835500,98398528,435500,97998528
2,1,229,-37.8265,145.0484,1335000,2248000,279372160,913000,278037160
3,2,431,-37.8269,145.0496,1825000,2248000,441972768,423000,440147768
2,1,150,-37.844,145.0496,840000,2248000,216941328,1408000,216101328
5,2,1250,-37.8245,145.0524,3500000,2248000,1091961344,-1252000,1088461344
2,1,0,-37.8245,145.0527,444000,835500,98396120,391500,97952120
3,2,213,-37.8302,145.0542,1320000,2248000,269690816,928000,268370816
3,1,477,-37.8257,145.0514,1890000,2248000,476734208,358000,474844208
4,2,697,-37.8307,145.0498,2450000,2248000,653559040,-202000,651109040
3,2,289,-37.8451,145.0525,1590000,2248000,329754208,658000,328164208
4,3,523,-37.8319,145.0503,2450000,2248000,517640768,-202000,515190768
2,1,172,-37.8437,145.0536,706000,2248000,234330336,1542000,233624336
5,3,757,-37.8176,145.0548,2500000,2248000,703937984,-252000,701437984
4,2,556,-37.8204,145.0516,2350000,2248000,542126848,-102000,539776848
2,1,326,-37.8373,145.0455,1385000,2248000,356030624,863000,354645624
2,1,1153,-37.8227,145.0528,655250,2248000,1009610432,1592750,1008955182
6,2,350,-37.8219,145.0556,1666000,2248000,382060288,582000,380394288
1,1,2276,-37.8343,145.0547,430000,2248000,1895752448,1818000,1895322448
2,1,0,-37.839,145.0459,505000,835500,98393640,330500,97888640
3,1,354,-37.8225,145.0551,1650000,2248000,379529344,598000,377879344
1,1,917,-37.8338,145.0545,371000,2248000,821736192,1877000,821365192
3,2,255,-37.8266,145.0493,1625000,2248000,302879936,623000,301254936
3,1,211,-37.8204,145.0489,975000,2248000,266512576,1273000,265537576
2,1,132,-37.7519,145.0687,546500,2248000,202716880,1701500,202170380
3,1,858,-37.7504,145.0643,1220000,2248000,777837184,1028000,776617184
3,1,235,-37.7519,145.0696,550000,2248000,285484416,1698000,284934416
2,1,182,-37.7587,145.0657,705000,2248000,242230784,1543000,241525784
2,1,187,-37.7518,145.0698,490000,2248000,246183968,1758000,245693968
3,1,600,-37.752,145.0722,1110000,2248000,573945088,1138000,572835088
2,1,153,-37.7538,145.0695,540000,2248000,219313872,1708000,218773872
3,1,577,-37.7494,145.0703,750000,2248000,555766784,1498000,555016784
5,2,580,-37.7539,145.0577,1401000,2248000,562456064,847000,561055064
3,1,662,-37.7507,145.062,1195000,2248000,622937152,1053000,621742152
2,1,110,-37.7489,145.07,690000,2248000,185330752,1558000,184640752
3,1,639,-37.7502,145.0605,1375000,2248000,604759360,873000,603384360
3,1,827,-37.748,145.0625,1400000,2248000,753336448,848000,751936448
2,1,247,-37.7502,145.069,475000,2248000,293601248,1773000,293126248
3,3,649,-37.7501,145.0822,1030000,2248000,615862272,1218000,614832272
3,1,0,-37.7502,145.0718,1125000,835500,99765352,-289500,98640352
5,4,2064,-37.7769,145.0605,3850000,2248000,1738450560,-1602000,1734600560
3,1,624,-37.7741,145.0506,1605000,2248000,592901504,643000,591296504
2,1,1473,-37.7713,145.0499,470000,2248000,1262498176,1778000,1262028176
4,3,948,-37.7759,145.063,1740000,2248000,853518976,508000,851778976
4,2,830,-37.7679,145.0673,1660000,2248000,758672064,588000,757012064
4,2,1004,-37.7689,145.0665,2200000,2248000,896183808,48000,893983808
4,3,583,-37.7719,145.0582,1875000,2248000,565056512,373000,563181512
5,3,826,-37.7793,145.0654,1797000,2248000,758470656,451000,756673656
3,2,180,-37.772,145.0538,1050000,2248000,243603904,1198000,242553904
3,1,610,-37.6885,144.9092,551000,2248000,581740288,1697000,581189288
3,1,600,-37.6866,144.9086,350000,2248000,573836672,1898000,573486672
3,1,650,-37.687,144.9084,425000,2248000,613351488,1823000,612926488
3,1,647,-37.6904,144.9121,600000,2248000,610983296,1648000,610383296
3,1,601,-37.6889,144.9109,460000,2248000,574628672,1788000,574168672
3,1,624,-37.6862,144.913,611000,2248000,592806592,1637000,592195592
3,1,598,-37.6878,144.9112,495000,2248000,572257856,1753000,571762856
2,1,729,-37.6909,144.9136,472500,2248000,674422592,1775500,673950092
3,2,218,-37.7133,145.0374,480000,2248000,273618240,1768000,273138240
3,1,907,-37.7143,145.039,980000,2248000,816541888,1268000,815561888
4,1,465,-37.7126,145.03,610000,2248000,468590368,1638000,467980368
3,2,468,-37.7125,145.0306,607500,2248000,471188672,1640500,470581172
2,2,180,-37.8115,144.8763,677200,2248000,242133072,1570800,241455872
3,2,269,-37.8108,144.8819,1155000,2248000,313839232,1093000,312684232
3,1,259,-37.8046,144.8831,817000,2248000,304342976,1431000,303525976
3,2,275,-37.8118,144.8801,1035000,2248000,318580032,1213000,317545032
2,1,224,-37.8083,144.8841,677500,2248000,275317376,1570500,274639876
3,1,350,-37.8123,144.8805,760000,2248000,376259456,1488000,375499456
2,2,84,-37.8058,144.8846,730000,2248000,166268832,1518000,165538832
2,1,117,-37.8083,144.8775,440000,2248000,190751344,1808000,190311344
2,1,220,-37.8068,144.8782,685000,2248000,272152384,1563000,271467384
1,1,0,-37.81,144.8786,210000,835500,96921056,625500,96711056
3,2,272,-37.8079,144.8825,1340000,2248000,316210176,908000,314870176
4,2,276,-37.8039,144.8849,925000,2248000,320738592,1323000,319813592
4,2,274,-37.8078,144.8825,1275000,2248000,319156992,973000,317881992
3,1,275,-37.8085,144.8802,925000,2248000,316986432,1323000,316061432
4,2,343,-37.8066,144.8811,1336000,2248000,373686592,912000,372350592
1,1,0,-37.8089,144.8788,200000,835500,96921040,635500,96721040
4,3,286,-37.8958,145.0696,1100000,2248000,330359296,1148000,329259296
3,2,302,-37.9043,145.0622,1160000,2248000,340041056,1088000,338881056
3,1,274,-37.8968,145.075,820000,2248000,316326400,1428000,315506400
2,1,161,-37.8955,145.073,740000,2248000,225655056,1508000,224915056
3,2,277,-37.8936,145.0709,975000,2248000,320287712,1273000,319312712
3,1,595,-37.9027,145.0684,1060000,2248000,570008960,1188000,568948960
2,1,275,-37.8936,145.0725,680000,2248000,315748608,1568000,315068608
3,1,618,-37.8991,145.0686,1430000,2248000,588185536,818000,586755536
3,2,834,-37.8959,145.0736,1370000,2248000,760485952,878000,759115952
2,2,5289,-37.8882,145.0666,605000,2248000,4279895552,1643000,4279290552
4,2,660,-37.8932,145.0681,1610000,2248000,624336512,638000,622726512
1,1,0,-37.8944,145.0733,256500,835500,97050816,579000,96794316
5,2,683,-37.9055,145.0691,1300000,2248000,643881728,948000,642581728
3,1,181,-37.8966,145.0737,835000,2248000,242827824,1413000,241992824
2,2,293,-37.9033,145.0727,861500,2248000,331568512,1386500,330707012
2,2,5289,-37.8882,145.0666,500000,2248000,4279895552,1748000,4279395552
4,2,557,-37.906,145.074,1400000,2248000,542940928,848000,541540928
2,1,102,-37.8894,145.0679,603000,2248000,179023584,1645000,178420584
3,2,506,-37.902,145.0705,1100000,2248000,501266848,1148000,500166848
3,2,553,-37.9031,145.0668,1090000,2248000,538408768,1158000,537318768
4,2,990,-37.8916,145.0753,1800000,2248000,885139456,448000,883339456
2,1,186,-37.8947,145.0722,745500,2248000,245411952,1502500,244666452
3,2,650,-37.8986,145.0359,1401000,2248000,615048256,847000,613647256
4,1,903,-37.9062,145.0263,2250000,2248000,814761792,-2000,812511792
4,2,705,-37.9035,145.028,1715000,2248000,659876608,533000,658161608
1,1,0,-37.9028,145.0475,250000,835500,97035912,585500,96785912
4,1,805,-37.9066,145.0354,1920000,2248000,737318016,328000,735398016
4,2,678,-37.9065,145.0461,1918000,2248000,638549888,330000,636631888
3,1,265,-37.906,145.04,900000,2248000,309193248,1348000,308293248
3,2,667,-37.9088,145.0471,1770000,2248000,628491328,478000,626721328
3,2,326,-37.903,145.0285,1250000,2248000,358987360,998000,357737360
3,2,0,-37.9018,145.0477,822500,835500,101361616,13000,100539116
2,1,210,-37.9001,145.0428,810000,2248000,264361664,1438000,263551664
3,1,551,-37.9036,145.0521,1322000,2248000,535225856,926000,533903856
4,3,718,-37.9061,145.0509,1845000,2248000,671758144,403000,669913144
3,1,578,-37.9047,145.0274,1535000,2248000,556548864,713000,555013864
4,2,691,-37.905,145.029,2005000,2248000,648813184,243000,646808184
3,2,180,-37.9069,145.041,932000,2248000,243611856,1316000,242679856
4,2,862,-37.8993,145.0447,1500000,2248000,783963264,748000,782463264
4,2,666,-37.9032,145.049,1390000,2248000,629067776,858000,627677776
3,1,397,-37.9064,145.0291,940000,2248000,413506048,1308000,412566048
1,1,0,-37.9028,145.0426,296000,835500,97032904,539500,96736904
2,1,0,-37.8986,145.042,475000,835500,98398256,360500,97923256
3,2,238,-37.9062,145.027,820000,2248000,289440448,1428000,288620448
3,2,382,-37.9061,145.0478,940000,2248000,403256288,1308000,402316288
3,2,0,-37.9071,145.0439,1470000,835500,101359912,-634500,99889912
2,1,0,-37.903,145.0452,430000,835500,98400736,405500,97970736
1,1,0,-37.9016,145.0414,362000,835500,97032016,473500,96670016
2,1,0,-37.903,145.0452,410000,835500,98400736,425500,97990736
2,1,452,-37.9024,145.0539,1177000,2248000,455621056,1071000,454444056
2,1,94,-37.9011,145.0474,617500,2248000,172689936,1630500,172072436
2,1,0,-37.9031,145.0444,405000,835500,98400264,430500,97995264
6,3,554,-37.8053,144.8681,1020000,2248000,544757184,1228000,543737184
2,1,444,-37.7933,144.876,912500,2248000,449176384,1335500,448263884
4,1,255,-37.7906,144.8687,710000,2248000,302537504,1538000,301827504
4,2,390,-37.7926,144.8639,837000,2248000,410818432,1411000,409981432
4,2,497,-37.7903,144.8639,850000,2248000,495380096,1398000,494530096
6,2,0,-37.809,144.8686,520000,835500,105339096,315500,104819096
3,1,0,-37.7964,144.8672,347000,835500,99644864,488500,99297864
2,1,0,-37.7952,144.8749,438000,835500,98283256,397500,97845256
2,1,80,-37.806,144.8674,415000,2248000,161503792,1833000,161088792
3,1,302,-37.8066,144.8666,723000,2248000,338315904,1525000,337592904
4,2,0,-37.809,144.8686,530000,835500,102606688,305500,102076688
3,1,347,-37.8067,144.8761,967000,2248000,373885248,1281000,372918248
3,1,442,-37.7914,144.8812,840000,2248000,448964960,1408000,448124960
3,1,412,-37.7941,144.881,910000,2248000,425256192,1338000,424346192
3,1,440,-37.7937,144.8732,820000,2248000,447379712,1428000,446559712
3,1,353,-37.7915,144.8733,756000,2248000,378623520,1492000,377867520
3,1,255,-37.8038,144.8679,620000,2248000,301172320,1628000,300552320
3,2,336,-37.7995,144.8794,875000,2248000,366786432,1373000,365911432
4,1,426,-37.7919,144.8793,830000,2248000,437685280,1418000,436855280
2,1,154,-37.8004,144.8647,545000,2248000,219983584,1703000,219438584
3,1,448,-37.7911,144.8821,913000,2248000,453707264,1335000,452794264
2,1,462,-37.8009,144.8653,850000,2248000,463396032,1398000,462546032
2,1,267,-37.8021,144.8629,770000,2248000,309286464,1478000,308516464
2,1,161,-37.7905,144.8714,495000,2248000,225518640,1753000,225023640
3,1,1000,-37.7936,144.8639,1575000,2248000,889941248,673000,888366248
1,1,628,-37.7993,144.8794,288000,2248000,593227968,1960000,592939968
3,1,536,-37.7978,144.8743,1151500,2248000,523249568,1096500,522098068
3,1,501,-37.7912,144.868,860000,2248000,495584416,1388000,494724416
3,1,372,-37.796,144.8728,805000,2248000,393639424,1443000,392834424
2,1,0,-37.7956,144.8762,450000,835500,98284104,385500,97834104
2,1,781,-37.8079,144.8684,420000,2248000,715504000,1828000,715084000
3,1,397,-37.7901,144.8682,878000,2248000,413393344,1370000,412515344
2,1,672,-37.7812,144.8121,765000,2248000,629323712,1483000,628558712
3,2,628,-37.7801,144.8121,730000,2248000,597509952,1518000,596779952
2,1,697,-37.7778,144.818,730000,2248000,649084480,1518000,648354480
3,2,605,-37.7792,144.8117,593000,2248000,579332672,1655000,578739672
4,1,837,-37.7825,144.8221,816000,2248000,762461760,1432000,761645760
2,1,534,-37.7795,144.8204,600000,2248000,520267392,1648000,519667392
3,1,697,-37.7842,144.8175,600000,2248000,650451072,1648000,649851072
1,1,2347,-37.7852,144.8272,185000,2248000,1951717888,2063000,1951532888
2,1,0,-37.7796,144.8252,319000,835500,98250832,516500,97931832
3,2,420,-37.7848,144.8231,560000,2248000,433135072,1688000,432575072
3,1,697,-37.7809,144.8228,840000,2248000,650454016,1408000,649614016
2,1,191,-37.8226,144.8392,507000,2248000,249211568,1741000,248704568
3,1,553,-37.8878,145.0456,1160000,2248000,536800640,1088000,535640640
3,2,295,-37.8904,145.0387,1330000,2248000,334492864,918000,333162864
2,1,0,-37.8866,145.0396,636500,835500,98395360,199000,97758860
5,3,688,-37.8921,145.0381,2575000,2248000,649405760,-327000,646830760
2,1,0,-37.8866,145.0396,710000,835500,98395360,125500,97685360
2,1,1784,-37.8966,145.0453,640000,2248000,1508293248,1608000,1507653248
2,1,0,-37.8994,145.0955,305000,835500,98431280,530500,98126280
2,1,0,-37.8991,145.0939,400000,835500,98430256,435500,98030256
3,1,670,-37.9033,145.1006,880000,2248000,629301248,1368000,628421248
3,1,602,-37.8923,145.1013,1045000,2248000,575560128,1203000,574515128
3,1,340,-37.8968,145.0983,690000,2248000,368500512,1558000,367810512
3,2,544,-37.9055,145.1024,1050000,2248000,531318240,1198000,530268240
3,1,691,-37.9109,145.0995,865000,2248000,645897792,1383000,645032792
3,1,548,-37.8951,145.101,1033000,2248000,532884064,1215000,531851064
2,2,607,-37.8964,145.0977,750000,2248000,579736896,1498000,578986896
3,1,543,-37.9023,145.105,1025000,2248000,528935904,1223000,527910904
3,2,279,-37.9001,145.1009,633500,2248000,321887488,1614500,321253988
4,1,604,-37.9087,145.0886,1180000,2248000,578500992,1068000,577320992
3,1,528,-37.9066,145.088,1225000,2248000,517071456,1023000,515846456
5,3,695,-37.8973,145.0979,1600000,2248000,654975296,648000,653375296
2,2,66,-37.8813,144.9964,755000,2248000,152121136,1493000,151366136
2,1,0,-37.8788,144.9974,520000,835500,98368480,315500,97848480
2,1,176,-37.8281,144.9923,1000000,2248000,237451968,1248000,236451968
1,1,0,-37.8301,144.9904,425000,835500,96992232,410500,96567232
3,2,324,-37.8278,144.9885,1280000,2248000,357373312,968000,356093312
3,2,324,-37.8278,144.9885,1475000,2248000,357373312,773000,355898312
2,1,131,-37.8274,144.9967,1015000,2248000,201891152,1233000,200876152
2,1,125,-37.8258,144.992,930000,2248000,197146256,1318000,196216256
3,2,263,-37.8266,144.9894,1900000,2248000,309165472,348000,307265472
2,1,0,-37.8255,144.9948,662500,835500,98360608,173000,97698108
2,1,151,-37.8311,144.9914,1010000,2248000,217694272,1238000,216684272
3,1,326,-37.8283,144.9946,1300000,2248000,357364448,948000,356064448
3,2,138,-37.8288,144.9891,1300000,2248000,210378208,948000,209078208
4,1,669,-37.8305,144.8736,930000,2248000,629728896,1318000,628798896
2,2,151,-37.8289,144.8671,650000,2248000,219210800,1598000,218560800
3,1,669,-37.8321,144.8736,985000,2248000,628362816,1263000,627377816
4,3,662,-37.8307,144.8725,915000,2248000,627382720,1333000,626467720
3,1,144,-37.8268,144.8675,508000,2248000,213451632,1740000,212943632
2,1,78,-37.8262,144.8677,420000,2248000,159925776,1828000,159505776
2,1,126,-37.8315,144.8693,506000,2248000,197861696,1742000,197355696
2,1,78,-37.8337,144.8739,380000,2248000,159930464,1868000,159550464
2,1,228,-37.8317,144.8713,611000,2248000,278473440,1637000,277862440
4,2,697,-37.7141,144.8995,1260000,2248000,653452800,988000,652192800
4,3,528,-37.7137,144.8987,931999,2248000,521484992,1316001,520552993
3,2,337,-37.7813,144.9371,1257000,2248000,367610080,991000,366353080
4,2,621,-37.7778,144.9346,1562000,2248000,593419200,686000,591857200
4,3,650,-37.7796,144.935,1740000,2248000,617931584,508000,616191584
2,1,0,-37.7847,144.9383,315000,835500,98321040,520500,98006040
5,2,521,-37.8868,145.0462,1335000,2248000,515837024,913000,514502024
5,3,705,-37.864,144.8437,1415000,2248000,662717888,833000,661302888
3,1,696,-37.725,144.8586,720000,2248000,649679104,1528000,648959104
2,1,161,-37.7251,144.8621,380000,2248000,225505216,1868000,225125216
3,1,255,-37.7243,144.8533,501000,2248000,301154016,1747000,300653016
3,1,695,-37.7259,144.8579,722000,2248000,648888512,1526000,648166512
4,3,308,-37.7231,144.8602,746000,2248000,347596704,1502000,346850704
3,1,166,-37.7169,144.8582,455000,2248000,230819552,1793000,230364552
4,2,231,-37.7263,144.8584,600000,2248000,285149728,1648000,284549728
3,1,338,-37.7212,144.8545,575000,2248000,366749216,1673000,366174216
3,2,554,-37.7212,144.8598,566000,2248000,539050240,1682000,538484240
3,2,236,-37.8982,145.0121,1250000,2248000,287849792,998000,286599792
2,1,0,-37.8971,145.0093,393000,835500,98377944,442500,97984944
2,1,0,-37.8994,145.0101,595000,835500,98378704,240500,97783704
4,3,474,-37.8988,145.0098,2200000,2248000,478899008,48000,476699008
4,2,256,-37.7833,144.9681,1908000,2248000,304981408,340000,303073408
3,3,240,-37.762,144.8916,1300000,2248000,292514080,948000,291214080
2,1,70,-37.7564,144.9043,470000,2248000,153617680,1778000,153147680
4,2,746,-37.7595,144.8993,1740000,2248000,692182656,508000,690442656
3,1,178,-37.8473,144.9495,1700000,2248000,240374656,548000,238674656
1,1,0,-37.8487,144.9511,1100000,835500,96970224,-264500,95870224
3,1,163,-37.8473,144.955,2150000,2248000,228523584,98000,226373584
2,1,111,-37.8445,144.9489,1190000,2248000,186057744,1058000,184867744
3,1,606,-37.8326,144.8594,916000,2248000,578565440,1332000,577649440
3,1,535,-37.8322,144.8399,910000,2248000,522442080,1338000,521532080
2,1,0,-37.8624,145.0223,480000,835500,98381872,355500,97901872
2,1,869,-37.8603,145.0224,852000,2248000,785151296,1396000,784299296
1,1,0,-37.8531,145.0115,405000,835500,97007928,430500,96602928
5,3,468,-37.7822,144.9065,2100000,2248000,475446208,148000,473346208
3,1,450,-37.7756,144.9148,1435000,2248000,455306144,813000,453871144
2,1,226,-37.7761,144.9165,1020000,2248000,276914112,1228000,275894112
6,3,1012,-37.7721,144.9184,2250000,2248000,906741120,-2000,904491120
4,3,0,-37.7831,144.9209,900000,835500,104229104,-64500,103329104
2,1,803,-37.8683,145.1064,1495000,2248000,733044288,753000,731549288
2,1,78,-37.8677,145.0981,822000,2248000,160072448,1426000,159250448
3,2,235,-37.8625,145.1083,890000,2248000,287114528,1358000,286224528
3,2,292,-37.7593,144.8561,765000,2248000,331994176,1483000,331229176
4,3,656,-37.7522,144.8659,1300000,2248000,622627648,948000,621327648
3,1,585,-37.7574,144.8574,760000,2248000,561959040,1488000,561199040
2,1,667,-37.7926,145.0842,1900000,2248000,625541056,348000,623641056
3,1,350,-37.7862,145.0739,700000,2248000,376375456,1548000,375675456
4,3,636,-37.789,145.0938,1890000,2248000,606966272,358000,605076272
4,3,627,-37.7827,145.0945,1725000,2248000,599853312,523000,598128312
3,2,601,-37.7524,145.0393,894000,2248000,576308480,1354000,575414480
3,3,338,-37.9166,145.0418,1375000,2248000,370074016,873000,368699016
2,1,0,-37.9296,145.0498,725000,835500,98406696,110500,97681696
4,3,635,-37.9107,145.0745,1515000,2248000,606178368,733000,604663368
3,1,337,-37.9331,145.0586,986000,2248000,366109408,1262000,365123408
3,2,372,-37.9127,145.0694,1225000,2248000,395367392,1023000,394142392
3,1,294,-37.919,145.0803,810000,2248000,332138272,1438000,331328272
2,1,1026,-37.911,145.0711,535000,2248000,909264128,1713000,908729128
4,1,587,-37.9194,145.057,1292000,2248000,565047744,956000,563755744
3,2,557,-37.9076,145.068,959000,2248000,541571200,1289000,540612200
2,1,171,-37.8158,145.1384,780000,2248000,233588960,1468000,232808960
3,1,689,-37.8262,145.1301,1760000,2248000,644326016,488000,642566016
3,2,693,-37.8229,145.1217,2080000,2248000,649074944,168000,646994944
2,1,555,-37.7854,144.8463,610000,2248000,536880384,1638000,536270384
2,1,604,-37.782,144.8528,760000,2248000,575608576,1488000,574848576
3,2,145,-37.7894,144.8463,441700,2248000,215817776,1806300,215376076
4,3,475,-37.7759,144.8552,1000000,2248000,479579744,1248000,478579744
3,2,517,-37.894,144.9977,2575000,2248000,509914400,-327000,507339400
4,4,473,-37.9104,144.9999,2900000,2248000,479697280,-652000,476797280
3,2,0,-37.911,144.9866,2225000,835500,101325096,-1389500,99100096
2,1,444,-37.8993,145.0046,975000,2248000,449267968,1273000,448292968
4,2,920,-37.8981,144.9902,4225000,2248000,829766912,-1977000,825541912
3,2,0,-37.928,145.0002,2100000,835500,101335464,-1264500,99235464
2,1,1647,-37.8847,144.9972,520000,2248000,1399991168,1728000,1399471168
4,2,286,-37.8981,145,2000000,2248000,328723424,248000,326723424
3,2,0,-37.901,145.0026,1990000,835500,101333752,-1154500,99343752
3,2,649,-37.9056,144.9893,3025000,2248000,614230016,-777000,611205016
3,2,0,-37.9163,144.9901,1221000,835500,101327872,-385500,100106872
5,2,780,-37.9173,145.0142,2140000,2248000,720508224,108000,718368224
3,1,597,-37.9064,145.0229,1635000,2248000,571561984,613000,569926984
4,3,312,-37.9295,145.0144,1700000,2248000,350877056,548000,349177056
5,3,583,-37.9057,145.0101,1900000,2248000,566408768,348000,564508768
3,2,119,-37.9084,145.0118,972000,2248000,195385856,1276000,194413856
3,1,506,-37.7723,144.9694,1652000,2248000,499596128,596000,497944128
2,1,173,-37.7586,144.9653,735000,2248000,235056272,1513000,234321272
3,1,282,-37.7674,144.966,1210000,2248000,322566496,1038000,321356496
1,1,0,-37.7767,144.9676,528000,835500,96971928,307500,96443928
3,1,249,-37.7669,144.9664,1115000,2248000,296486848,1133000,295371848
2,1,638,-37.762,144.9647,320000,2248000,602545280,1928000,602225280
3,2,192,-37.7743,144.9637,1260000,2248000,253032304,988000,251772304
4,2,373,-37.7733,144.9599,1210000,2248000,397440128,1038000,396230128
4,2,650,-37.7575,144.9716,1385000,2248000,616358272,863000,614973272
3,2,122,-37.7698,144.9661,981000,2248000,197712304,1267000,196731304
1,1,0,-37.7783,144.9635,418000,835500,96969584,417500,96551584
2,1,430,-37.7609,144.9623,585000,2248000,438161504,1663000,437576504
4,3,0,-37.775,144.9513,1900000,835500,104246856,-1064500,102346856
2,1,148,-37.7731,144.9568,884000,2248000,215295280,1364000,214411280
2,1,557,-37.7732,144.951,480000,2248000,538523904,1768000,538043904
4,1,449,-37.7671,144.9762,1310000,2248000,455918848,938000,454608848
2,1,263,-37.7661,144.9742,1283000,2248000,306189504,965000,304906504
2,1,137,-37.7738,144.9733,1015000,2248000,206612208,1233000,205597208
2,1,0,-37.7755,144.9786,435000,835500,98344776,400500,97909776
2,1,0,-37.7761,144.975,835000,835500,98342632,500,97507632
3,1,446,-37.7682,144.9835,1500000,2248000,452186400,748000,450686400
2,1,1097,-37.7686,144.9421,407500,2248000,965279360,1840500,964871860
2,1,207,-37.7622,144.9406,825000,2248000,261911648,1423000,261086648
3,3,131,-37.7559,144.9378,645000,2248000,206399248,1603000,205754248
3,1,335,-37.766,144.945,1220000,2248000,364439264,1028000,363219264
3,2,169,-37.7585,144.9504,1100000,2248000,234845376,1148000,233745376
3,1,109,-37.7609,144.9416,670000,2248000,185829024,1578000,185159024
2,1,559,-37.7707,144.9488,640000,2248000,540102912,1608000,539462912
2,1,0,-37.7711,144.9487,545000,835500,98325848,290500,97780848
4,2,518,-37.7606,144.9499,1205000,2248000,512025824,1043000,510820824
3,1,0,-37.7769,145.088,860000,835500,99778472,-24500,98918472
2,1,135,-37.7787,145.0918,599900,2248000,205105152,1648100,204505252
4,2,190,-37.7664,145.0884,910000,2248000,252893712,1338000,251983712
3,2,709,-37.7612,145.0968,1100000,2248000,661697152,1148000,660597152
5,4,564,-37.7735,145.0936,1730000,2248000,553022272,518000,551292272
6,2,665,-37.8493,145.1283,1591000,2248000,631052352,657000,629461352
3,2,267,-37.8463,145.1071,975000,2248000,312401440,1273000,311426440
2,1,698,-37.8518,145.1278,1815000,2248000,650074112,433000,648259112
3,2,862,-37.8603,145.0979,1590000,2248000,782625216,658000,781035216
4,2,863,-37.8539,145.1127,1601000,2248000,784790080,647000,783189080
5,1,633,-37.8557,145.1285,1225000,2248000,602804224,1023000,601579224
3,1,643,-37.8405,145.0924,1930000,2248000,607950784,318000,606020784
4,2,670,-37.8378,145.089,2216000,2248000,632245888,32000,630029888
4,1,572,-37.8411,145.062,2110000,2248000,553187072,138000,551077072
2,1,633,-37.8427,145.0824,1900000,2248000,598675648,348000,596775648
3,2,575,-37.8378,145.0909,1620000,2248000,555802432,628000,554182432
4,2,790,-37.8269,145.0661,3550000,2248000,727066432,-1302000,723516432
3,1,400,-37.8333,145.0616,1905000,2248000,415888384,343000,413983384
4,2,742,-37.8284,145.0673,2990000,2248000,689132992,-742000,686142992
3,1,112,-37.8378,145.0949,835000,2248000,188303312,1413000,187468312
5,5,2079,-37.8179,145.0694,8000000,2248000,1751908608,-5752000,1743908608
4,2,515,-37.7817,144.9742,3450000,2248000,509672352,-1202000,506222352
2,1,0,-37.8981,145.0619,635000,835500,98410448,200500,97775448
1,1,0,-37.8858,145.0632,305000,835500,97043592,530500,96738592
3,2,515,-37.8924,145.0541,1200000,2248000,508368320,1048000,507168320
3,1,1103,-37.8958,145.0603,945000,2248000,971474944,1303000,970529944
4,2,615,-37.8928,145.0531,1667000,2248000,588763776,581000,587096776
1,1,0,-37.8944,145.0616,330000,835500,97043608,505500,96713608
3,1,0,-37.8866,145.0561,577000,835500,99771728,258500,99194728
1,1,750,-37.8678,145.0197,305000,2248000,689738880,1943000,689433880
2,2,0,-37.8607,145.0116,742500,835500,99968360,93000,99225860
2,1,0,-37.8937,145.0137,630000,835500,98380256,205500,97750256
3,2,305,-37.8899,145.023,1350000,2248000,342386144,898000,341036144
2,1,0,-37.8906,145.0259,490000,835500,98387408,345500,97897408
3,2,235,-37.8856,145.0934,701000,2248000,287108096,1547000,286407096
3,1,418,-37.886,145.096,905000,2248000,430141120,1343000,429236120
3,2,286,-37.8755,145.0954,988000,2248000,327413312,1260000,326425312
3,2,213,-37.8827,145.0942,820000,2248000,269721632,1428000,268901632
3,1,230,-37.788,144.9967,1500000,2248000,281492256,748000,279992256
2,1,72,-37.7881,145.0058,641000,2248000,155264496,1607000,154623496
2,1,158,-37.7925,144.9995,1250000,2248000,223226816,998000,221976816
3,1,276,-37.7933,144.9938,1652500,2248000,317844896,595500,316192396
1,1,0,-37.7881,145.0058,465000,835500,96996768,370500,96531768
2,1,388,-37.7506,144.9694,495000,2248000,404972128,1753000,404477128
2,1,275,-37.7424,144.9576,930000,2248000,315660096,1318000,314730096
2,1,0,-37.7422,144.9604,781000,835500,98329648,54500,97548648
2,1,0,-37.7519,144.9496,677776,835500,98324144,157724,97646368
4,2,3747,-37.7551,144.9787,680000,2248000,3063917568,1568000,3063237568
3,1,120,-37.7462,144.9795,824000,2248000,194543920,1424000,193719920
4,2,453,-37.7503,144.9481,1500000,2248000,460654080,748000,459154080
4,2,172,-37.7483,144.9634,1005000,2248000,238589264,1243000,237584264
4,2,398,-37.7364,144.9787,901000,2248000,417204800,1347000,416303800
3,1,414,-37.7432,144.9573,990000,2248000,426877760,1258000,425887760
6,3,768,-37.7397,144.9603,1455000,2248000,713930112,793000,712475112
3,2,500,-37.7382,144.9653,1250000,2248000,496441056,998000,495191056
5,3,635,-37.7516,144.9593,1790000,2248000,607454976,458000,605664976
2,1,136,-37.7449,144.9754,650000,2248000,205819824,1598000,205169824
3,2,531,-37.7424,144.9571,720000,2248000,520935840,1528000,520215840
3,2,531,-37.7424,144.9571,720000,2248000,520935840,1528000,520215840
2,1,0,-37.7981,144.9883,535000,835500,98353384,300500,97818384
2,1,15900,-37.8035,144.985,945000,2248000,12664103936,1303000,12663158936
2,1,112,-37.8001,144.9901,888000,2248000,186868192,1360000,185980192
3,2,0,-37.8083,144.9908,1000000,835500,101315608,-164500,100315608
3,1,117,-37.8298,144.9923,1350000,2248000,192190720,898000,190840720
4,2,872,-37.7906,145.1138,1300000,2248000,791895936,948000,790595936
4,2,664,-37.7895,145.1116,1400000,2248000,627512384,848000,626112384
4,3,661,-37.7905,145.1433,1100000,2248000,626754304,1148000,625654304
3,1,814,-37.7909,145.1309,1355000,2248000,743109760,893000,741754760
5,2,697,-37.7459,144.9159,1652000,2248000,654832832,596000,653180832
3,1,387,-37.755,144.9272,1131000,2248000,405522560,1117000,404391560
1,1,845,-37.7469,144.9206,310000,2248000,764742016,1938000,764432016
3,1,227,-37.7496,144.892,700000,2248000,279052448,1548000,278352448
2,1,0,-37.7504,144.8957,610000,835500,98290792,225500,97680792
3,2,411,-37.7544,144.8986,960000,2248000,426065312,1288000,425105312
1,1,62,-37.7578,144.9134,426500,2248000,145934848,1821500,145508348
2,1,0,-37.7847,145.0109,676000,835500,98365720,159500,97689720
3,1,574,-37.783,145.0165,1500000,2248000,553366656,748000,551866656
3,1,585,-37.695,144.9676,660000,2248000,562019520,1588000,561359520
3,1,578,-37.6966,144.9695,741000,2248000,556488768,1507000,555747768
3,2,207,-37.7049,144.9631,532000,2248000,264878256,1716000,264346256
3,1,1069,-37.6931,144.9596,1000000,2248000,944518912,1248000,943518912
2,1,0,-37.7071,144.9644,328000,835500,98327992,507500,97999992
3,3,247,-37.7133,144.975,543500,2248000,298091776,1704500,297548276
1,1,0,-37.777,144.9836,330000,835500,96981800,505500,96651800
2,1,160,-37.7933,144.9824,846000,2248000,224796992,1402000,223950992
2,1,192,-37.7793,144.9879,1055000,2248000,250088288,1193000,249033288
3,2,226,-37.7824,144.9243,1250000,2248000,279879168,998000,278629168
2,1,274,-37.7813,144.9238,953000,2248000,314853568,1295000,313900568
2,1,0,-37.788,144.9306,603000,835500,98316688,232500,97713688
3,1,320,-37.7844,144.9359,940000,2248000,352581344,1308000,351641344
5,1,432,-37.7859,144.9323,1550000,2248000,443825184,698000,442275184
2,1,0,-37.7829,144.9247,500000,835500,98312464,335500,97812464
2,1,0,-37.7826,144.9311,450000,835500,98316368,385500,97866368
2,1,472,-37.7851,144.922,390000,2248000,471332096,1858000,470942096
3,1,180,-37.7839,144.9273,1085000,2248000,241934160,1163000,240849160
2,1,209,-37.7846,144.9347,1060000,2248000,263491232,1188000,262431232
3,1,143,-37.7868,144.9336,917000,2248000,212697312,1331000,211780312
2,1,267,-37.7961,144.89,885000,2248000,309302432,1363000,308417432
2,2,0,-37.7883,144.884,485000,835500,99881320,350500,99396320
3,1,219,-37.796,144.8819,760000,2248000,272729280,1488000,271969280
3,1,267,-37.7951,144.8901,871000,2248000,310668576,1377000,309797576
2,1,172,-37.7936,144.8905,882000,2248000,234224064,1366000,233342064
3,1,272,-37.7977,144.904,895000,2248000,314628960,1353000,313733960
1,1,1162,-37.8911,145.0451,260000,2248000,1015360320,1988000,1015100320
3,2,269,-37.854,145.0542,1452000,2248000,313950336,796000,312498336
3,1,732,-37.8562,145.0864,1800000,2248000,678285568,448000,676485568
3,2,0,-37.8574,145.0494,1253000,835500,101357440,-417500,100104440
4,3,622,-37.858,145.0859,1760000,2248000,595905280,488000,594145280
3,3,662,-37.8605,145.0455,3310000,2248000,626126464,-1062000,622816464
3,1,453,-37.8487,145.0592,1601000,2248000,457774528,647000,456173528
2,1,157,-37.8499,145.0814,910000,2248000,222493680,1338000,221583680
3,1,742,-37.702,144.9538,780000,2248000,686088768,1468000,685308768
2,2,1137,-37.7045,144.9204,420000,2248000,998463552,1828000,998043552
3,1,697,-37.7097,144.9256,895000,2248000,650508928,1353000,649613928
3,1,751,-37.6962,144.9376,885000,2248000,693190784,1363000,692305784
3,1,663,-37.6962,144.9349,597500,2248000,623642816,1650500,623045316
3,1,738,-37.6972,144.941,822000,2248000,682919168,1426000,682097168
5,1,227,-37.6979,144.941,645000,2248000,281808928,1603000,281163928
3,1,258,-37.7047,144.9087,595000,2248000,303556704,1653000,302961704
4,3,715,-37.709,144.9373,1050000,2248000,669294144,1198000,668244144
3,1,694,-37.6974,144.9112,705000,2248000,648127616,1543000,647422616
3,2,0,-37.7074,144.9266,590000,835500,101264240,245500,100674240
3,2,243,-37.7116,144.9357,680000,2248000,293312928,1568000,292632928
3,1,666,-37.7015,144.9191,935000,2248000,626004672,1313000,625069672
3,1,605,-37.706,144.9467,740000,2248000,577813952,1508000,577073952
2,2,516,-37.9365,145.0008,837000,2248000,507764832,1411000,506927832
4,3,684,-37.9436,145.0169,2500000,2248000,644871424,-252000,642371424
2,1,90,-37.9354,144.9994,860000,2248000,169503264,1388000,168643264
3,1,338,-37.8139,145.0243,1700000,2248000,366864576,548000,365164576
1,1,0,-37.8194,145.0397,440000,835500,97021320,395500,96581320
1,1,918,-37.8294,145.033,535000,2248000,822512704,1713000,821977704
2,1,2679,-37.8261,145.0269,635000,2248000,2215590656,1613000,2214955656
1,1,0,-37.826,145.0239,317500,835500,97012368,518000,96694868
1,1,6494,-37.8254,145.0255,360000,2248000,5229213696,1888000,5228853696
2,1,221,-37.8163,145.0251,1800000,2248000,273034176,448000,271234176
1,1,479,-37.8292,145.0322,275000,2248000,475570976,1973000,475295976
3,1,269,-37.8162,145.0206,1525000,2248000,312331936,723000,310806936
2,1,0,-37.832,145.0431,560000,835500,98391112,275500,97831112
3,2,0,-37.8302,145.0527,1264000,835500,101356288,-428500,100092288
4,3,667,-37.8374,145.0511,3600000,2248000,631444864,-1352000,627844864
3,2,185,-37.8255,145.0481,1405000,2248000,247558144,843000,246153144
2,1,0,-37.8254,145.0474,555000,835500,98392968,280500,97837968
3,2,330,-37.7524,145.06,1271000,2248000,362150208,977000,360879208
2,1,263,-37.7428,145.0511,665000,2248000,306234112,1583000,305569112
3,1,192,-37.7388,145.0581,575000,2248000,251492960,1673000,250917960
4,1,374,-37.7437,145.0506,706000,2248000,396689472,1542000,395983472
3,1,317,-37.7397,145.0513,657000,2248000,350276256,1591000,349619256
3,2,0,-37.7502,145.0465,630000,835500,101343056,205500,100713056
2,1,465,-37.7369,145.0371,650000,2248000,465865120,1598000,465215120
3,1,658,-37.7445,145.0386,855000,2248000,619760832,1393000,618905832
2,1,391,-37.7349,145.0398,613000,2248000,407384480,1635000,406771480
3,1,476,-37.7339,145.0405,640000,2248000,475926368,1608000,475286368
4,4,370,-37.8919,145.0781,1340000,2248000,398342400,908000,397002400
4,2,449,-37.777,145.0414,1410000,2248000,457553408,838000,456143408
4,2,589,-37.7671,145.037,1650000,2248000,568191424,598000,566541424
3,2,618,-37.7817,145.0391,1851000,2248000,589746816,397000,587895816
5,3,737,-37.7794,145.0647,2325000,2248000,688133568,-77000,685808568
3,2,1132,-37.7715,145.0688,2400000,2248000,995977472,-152000,993577472
4,2,658,-37.7358,144.8217,646000,2248000,622585792,1602000,621939792
3,2,573,-37.7473,144.8555,843000,2248000,554066368,1405000,553223368
3,2,700,-37.7322,144.8722,835000,2248000,654442816,1413000,653607816
3,2,162,-37.7308,144.8664,635000,2248000,229258320,1613000,228623320
3,1,535,-37.7475,144.852,745000,2248000,522439584,1503000,521694584
3,1,703,-37.746,144.8651,941000,2248000,655217728,1307000,654276728
5,5,609,-37.8064,145.0451,3800000,2248000,590152960,-1552000,586352960
3,2,0,-37.794,145.033,752000,835500,101339912,83500,100587912
3,1,111,-37.7941,145.0238,690000,2248000,187464112,1558000,186774112
4,2,320,-37.8127,145.0451,2600000,2248000,355611392,-352000,353011392
5,4,800,-37.8147,145.0571,4515000,2248000,739515136,-2267000,735000136
2,1,826,-37.805,145.0546,820000,2248000,751181760,1428000,750361760
3,2,247,-37.7944,145.0327,835000,2248000,296543552,1413000,295708552
2,1,838,-37.7974,145.0526,590000,2248000,760663232,1658000,760073232
3,2,422,-37.7927,145.056,1402000,2248000,434859968,846000,433457968
3,1,276,-37.8082,144.8828,1190000,2248000,317778336,1058000,316588336
4,1,318,-37.8105,144.8803,1205000,2248000,352335808,1043000,351130808
3,1,555,-37.8083,144.8754,860000,2248000,538267136,1388000,537407136
2,1,315,-37.7835,144.8723,472500,2248000,347224384,1775500,346751884
3,2,159,-37.785,144.8673,675000,2248000,226894336,1573000,226219336
2,2,2787,-37.7794,144.872,405000,2248000,2302435840,1843000,2302030840
3,1,660,-37.7851,144.8654,930000,2248000,621239616,1318000,620309616
1,1,0,-37.8691,145.0345,365000,835500,97023960,470500,96658960
3,2,192,-37.8654,145.0297,2250000,2248000,253083584,-2000,250833584
3,1,840,-37.883,145.0791,2250000,2248000,763636480,-2000,761386480
4,2,709,-37.8693,145.0423,3200000,2248000,663042496,-952000,659842496
3,2,711,-37.8723,145.0387,2020000,2248000,663255040,228000,661235040
2,1,259,-37.8718,145.0526,1211000,2248000,303088992,1037000,301877992
4,2,230,-37.8806,145.0831,1380000,2248000,284515808,868000,283135808
4,3,380,-37.8792,145.0869,1715157,2248000,404656096,532843,402940939
3,1,446,-37.8784,145.0654,1220000,2248000,452249728,1028000,451029728
5,3,601,-37.7637,144.8843,1620000,2248000,580540096,628000,578920096
4,3,224,-37.7641,144.8885,1190000,2248000,281233856,1058000,280043856
4,2,0,-37.8177,144.9544,1850000,835500,102660512,-1014500,100810512
1,1,0,-37.8122,144.9582,333000,835500,96970312,502500,96637312
2,1,0,-37.8084,144.9602,452000,835500,98337304,383500,97885304
1,1,0,-37.8199,144.9558,275000,835500,96969736,560500,96694736
2,2,1136,-37.8211,144.9559,683000,2248000,997708864,1565000,997025864
2,1,0,-37.8106,144.9646,640000,835500,98340272,195500,97700272
4,2,719,-37.812,145.1082,2100000,2248000,670979392,148000,668879392
2,1,0,-37.7679,144.9245,439000,835500,98310576,396500,97871576
2,1,313,-37.7663,144.9098,1040000,2248000,345664864,1208000,344624864
3,2,803,-37.7627,144.9047,1670000,2248000,735867200,578000,734197200
4,2,675,-37.7686,144.912,1940000,2248000,636080320,308000,634140320
2,2,0,-37.7675,144.92,560000,835500,99901032,275500,99341032
4,2,574,-37.7644,144.9061,1515000,2248000,556256064,733000,554741064
5,2,597,-37.7611,144.9095,2300000,2248000,575800896,-52000,573500896
2,1,272,-37.7641,144.9073,970000,2248000,313260832,1278000,312290832
3,1,231,-37.7616,144.9284,1070000,2248000,282237472,1178000,281167472
2,2,0,-37.7679,144.9245,542000,835500,99903848,293500,99361848
3,2,275,-37.767,144.9108,1240000,2248000,318593696,1008000,317353696
4,2,431,-37.7615,144.9094,955000,2248000,443244992,1293000,442289992
4,2,651,-37.8879,145.0768,1656000,2248000,617228672,592000,615572672
2,1,1113,-37.8892,145.0664,582000,2248000,978014720,1666000,977432720
3,1,557,-37.9059,145.0733,1255000,2248000,539980992,993000,538725992
2,1,77,-37.8999,145.0643,535000,2248000,159265120,1713000,158730120
2,2,0,-37.8882,145.0666,586000,835500,100005440,249500,99419440
4,2,402,-37.8433,144.8774,1230000,2248000,420316192,1018000,419086192
4,2,480,-37.8439,144.8733,1560000,2248000,481957088,688000,480397088
3,2,333,-37.8334,144.8673,975000,2248000,364412064,1273000,363437064
5,2,760,-37.8437,144.865,1820000,2248000,704601856,428000,702781856
3,2,575,-37.8389,144.8666,900000,2248000,555664640,1348000,554764640
4,2,540,-37.8339,144.8716,956000,2248000,529372800,1292000,528416800
4,1,837,-37.837,144.8772,1650000,2248000,762502016,598000,760852016
4,2,580,-37.8477,144.8903,2337000,2248000,560997824,-89000,558660824
3,1,452,-37.8402,144.8886,1075000,2248000,456878240,1173000,455803240
3,2,297,-37.738,144.8865,810000,2248000,335961856,1438000,335151856
2,1,167,-37.7343,144.8824,510000,2248000,230260608,1738000,229750608
1,1,710,-37.7355,144.8874,325000,2248000,658029888,1923000,657704888
3,2,202,-37.7418,144.8833,800000,2248000,260881984,1448000,260081984
3,1,1218,-37.736,144.8886,500000,2248000,1062234880,1748000,1061734880
2,2,1106,-37.7679,144.9994,680000,2248000,974020352,1568000,973340352
3,1,191,-37.7717,144.995,1300000,2248000,250667696,948000,249367696
2,1,228,-37.7634,144.9985,995000,2248000,278543680,1253000,277548680
5,2,406,-37.7751,145.0099,1750000,2248000,424917184,498000,423167184
2,1,181,-37.7659,144.9903,1050000,2248000,241394896,1198000,240344896
3,1,534,-37.7677,145.0142,1235000,2248000,521751488,1013000,520516488
2,1,161,-37.712,144.9175,600000,2248000,225537792,1648000,224937792
3,1,220,-37.7131,144.9091,601000,2248000,273526592,1647000,272925592
3,2,341,-37.7166,144.9104,755000,2248000,370747232,1493000,369992232
3,1,0,-37.7188,144.9243,648000,835500,99670888,187500,99022888
4,2,537,-37.91,145.096,1615000,2248000,527148992,633000,525533992
3,1,160,-37.8946,145.0944,655000,2248000,226244048,1593000,225589048
5,3,707,-37.9098,145.097,1351000,2248000,664459840,897000,663108840
4,3,691,-37.8999,145.0993,1600000,2248000,650449088,648000,648849088
4,2,598,-37.898,145.0928,1840000,2248000,575353792,408000,573513792
5,2,699,-37.908,145.0502,2250000,2248000,656515200,-2000,654265200
2,1,0,-37.9023,145.0461,437500,835500,98401216,398000,97963716
3,2,199,-37.9034,145.0409,960000,2248000,258627072,1288000,257667072
4,2,314,-37.9084,145.0532,1425000,2248000,350885824,823000,349460824
3,2,180,-37.7961,144.9538,2790000,2248000,243545184,-542000,240755184
3,2,294,-37.7215,144.9251,755000,2248000,333612768,1493000,332857768
2,1,587,-37.7306,144.9357,999000,2248000,562218432,1249000,561219432
4,1,593,-37.7278,144.9463,800000,2248000,569698816,1448000,568898816
4,1,596,-37.7195,144.9456,770000,2248000,572068352,1478000,571298352
3,1,0,-37.7243,144.9473,585000,835500,99685688,250500,99100688
3,1,321,-37.7242,144.9424,708000,2248000,353368576,1540000,352660576
2,1,134,-37.7216,144.9292,427500,2248000,204208048,1820500,203780548
3,2,141,-37.7177,144.9328,560000,2248000,212701392,1688000,212141392
2,1,0,-37.7324,144.9377,520000,835500,98314520,315500,97794520
5,2,706,-37.7328,144.9281,958000,2248000,661951552,1290000,660993552
3,3,92,-37.8368,144.9463,1400000,2248000,175592336,848000,174192336
2,1,2166,-37.8415,144.9412,520000,2248000,1810116864,1728000,1809596864
2,2,0,-37.84,144.939,801000,835500,99921240,34500,99120240
3,2,368,-37.8323,144.9463,2400000,2248000,392121024,-152000,389721024
2,1,7159,-37.841,144.9386,575000,2248000,5756077056,1673000,5755502056
4,3,317,-37.8346,144.9358,2700000,2248000,354769024,-452000,352069024
2,1,0,-37.8443,144.9442,600000,835500,98331672,235500,97731672
2,2,21715,-37.8424,144.9449,1030000,2248000,17261264896,1218000,17260234896
2,1,2842,-37.8513,144.9943,645000,2248000,2344392448,1603000,2343747448
2,1,72,-37.8542,145.0024,550000,2248000,155270176,1698000,154720176
2,1,0,-37.8538,145.0088,630000,835500,98372560,205500,97742560
2,1,8220,-37.8508,144.9874,685000,2248000,6594614272,1563000,6593929272
1,1,108,-37.8508,145.0051,860000,2248000,182355968,1388000,181495968
3,2,572,-37.736,145.0033,1190000,2248000,553365696,1058000,552175696
3,2,604,-37.7438,144.9971,1121000,2248000,578652352,1127000,577531352
3,2,472,-37.7336,145.0022,917500,2248000,474334912,1330500,473417412
3,2,319,-37.7334,144.9873,800000,2248000,353410016,1448000,352610016
4,1,521,-37.7506,144.99,1075000,2248000,512826912,1173000,511751912
3,1,624,-37.7373,144.9864,1000000,2248000,592857792,1248000,591857792
3,1,674,-37.7341,145.0275,910000,2248000,632397632,1338000,631487632
3,1,581,-37.7536,145.0191,690000,2248000,558896896,1558000,558206896
3,2,637,-37.7344,145.0208,1100000,2248000,604745728,1148000,603645728
1,1,896,-37.7316,145.0201,385000,2248000,805106688,1863000,804721688
3,1,490,-37.7152,144.9817,595000,2248000,486952224,1653000,486357224
4,2,696,-37.7074,145.0276,905000,2248000,652740544,1343000,651835544
5,2,676,-37.7114,145.021,845000,2248000,638297216,1403000,637452216
3,2,213,-37.7085,145.018,815000,2248000,269654240,1433000,268839240
4,3,697,-37.701,144.9993,770000,2248000,655105984,1478000,654335984
3,1,435,-37.7054,144.9945,610000,2248000,443492480,1638000,442882480
2,1,419,-37.721,145.016,861500,2248000,429496544,1386500,428635044
3,1,551,-37.7194,145.0015,801000,2248000,535173088,1447000,534372088
2,1,143,-37.6955,145.0097,490000,2248000,211367248,1758000,210877248
3,1,371,-37.7068,145.0193,605000,2248000,392928768,1643000,392323768
2,2,254,-37.7071,145.0108,652000,2248000,300685728,1596000,300033728
2,1,101,-37.7091,145.0259,375000,2248000,178186240,1873000,177811240
2,1,110,-37.7216,145.0099,505000,2248000,185290528,1743000,184785528
2,1,113,-37.8119,144.9947,950000,2248000,187662720,1298000,186712720
2,1,826,-37.821,145.0054,1226000,2248000,751153408,1022000,749927408
3,1,176,-37.8162,145.006,1214000,2248000,238825184,1034000,237611184
3,1,0,-37.833,144.997,790000,835500,99729040,45500,98939040
2,2,0,-37.8151,145.0003,1090000,835500,99956048,-254500,98866048
3,1,240,-37.8221,144.9964,1785000,2248000,289399104,463000,287614104
2,1,7455,-37.822,145.0104,560000,2248000,5990046720,1688000,5989486720
2,1,134,-37.817,145.0058,1050000,2248000,204266400,1198000,203216400
3,1,0,-37.8221,144.9988,1052000,835500,99728880,-216500,98676880
3,2,230,-37.8213,144.9948,3000000,2248000,283088288,-752000,280088288
3,1,154,-37.8264,145.0123,1330000,2248000,221443680,918000,220113680
1,1,126,-37.8259,145.0107,911000,2248000,196581888,1337000,195670888
2,1,190,-37.7437,145.0729,615000,2248000,248555840,1633000,247940840
2,1,269,-37.8026,144.8882,665000,2248000,310882688,1583000,310217688
3,2,197,-37.8395,144.9489,2240000,2248000,256982336,8000,254742336
1,1,0,-37.8344,144.9581,460000,835500,96972856,375500,96512856
2,1,438,-37.8353,144.9599,650000,2248000,444491136,1598000,443841136
2,1,327,-37.8351,144.964,1100000,2248000,356770496,1148000,355670496
3,1,204,-37.8365,144.9497,1820000,2248000,260921280,428000,259101280
3,2,0,-37.8309,144.9686,680000,835500,101304592,155500,100624592
3,2,0,-37.8319,144.9682,710000,835500,101304464,125500,100594464
2,1,161,-37.8454,144.9891,1214000,2248000,225597520,1034000,224383520
2,1,5467,-37.8406,145.0035,485000,2248000,4418931200,1763000,4418446200
2,2,208,-37.8433,145.0024,1710000,2248000,264342784,538000,262632784
2,1,0,-37.8383,144.9995,792500,835500,98365000,43000,97572500
1,1,775,-37.8354,144.984,390500,2248000,709470464,1857500,709079964
2,2,2920,-37.8709,144.9807,610500,2248000,2407622912,1637500,2407012412
2,1,135,-37.8661,144.9802,1120000,2248000,205046720,1128000,203926720
2,1,455,-37.8636,144.9749,1077000,2248000,457938816,1171000,456861816
2,1,165,-37.8658,144.9774,1301000,2248000,228753920,947000,227452920
2,1,194,-37.8658,144.9795,1440000,2248000,251673888,808000,250233888
3,1,0,-37.8718,144.9767,1000000,835500,99721112,-164500,98721112
3,1,460,-37.8623,144.9772,1190000,2248000,463257696,1058000,462067696
2,1,0,-37.857,144.9867,482000,835500,98359320,353500,97877320
4,1,543,-37.7199,144.9044,810000,2248000,530157248,1438000,529347248
3,2,371,-37.7229,144.9055,1021000,2248000,394453952,1227000,393432952
5,2,533,-37.7189,144.9044,910000,2248000,525213600,1338000,524303600
3,2,572,-37.7966,144.8256,940000,2248000,553263488,1308000,552323488
4,2,567,-37.7866,144.8458,726000,2248000,550689472,1522000,549963472
4,1,654,-37.7803,144.8415,990000,2248000,617848768,1258000,616858768
3,1,483,-37.7875,144.8456,710000,2248000,481344832,1538000,480634832
3,1,462,-37.7894,144.8383,840000,2248000,464744320,1408000,463904320
4,1,665,-37.7662,144.8383,775000,2248000,626538432,1473000,625763432
3,1,546,-37.7676,144.8307,490000,2248000,531122176,1758000,530632176
3,1,534,-37.7886,144.821,716000,2248000,521635072,1532000,520919072
4,2,332,-37.7962,144.8064,515000,2248000,364946112,1733000,364431112
3,1,573,-37.8017,144.8258,530000,2248000,552461184,1718000,551931184
4,2,572,-37.7912,144.7979,685000,2248000,554611968,1563000,553926968
3,3,134,-37.79,144.7886,521000,2248000,208682320,1727000,208161320
3,1,757,-37.7845,144.8088,571000,2248000,697863680,1677000,697292680
2,1,180,-37.8351,145.103,825000,2248000,240682128,1423000,239857128
3,2,347,-37.8323,145.105,1525000,2248000,375622400,723000,374097400
2,1,269,-37.8201,145.0887,1260000,2248000,311008128,988000,309748128
4,2,764,-37.818,145.0946,2360000,2248000,706535104,-112000,704175104
2,2,323,-37.823,145.0993,1250000,2248000,355284416,998000,354034416
4,1,600,-37.8327,145.0976,1600000,2248000,575336448,648000,573736448
4,3,773,-37.8263,145.0911,2370000,2248000,715239872,-122000,712869872
3,1,463,-37.7593,144.9885,1195000,2248000,465623456,1053000,464428456
2,1,0,-37.7554,144.982,716000,835500,98344496,119500,97628496
3,2,0,-37.7579,145,998000,835500,101315344,-162500,100317344
2,1,0,-37.7549,144.9979,600000,835500,98354208,235500,97754208
3,2,349,-37.7544,144.998,1346000,2248000,377128000,902000,375782000
3,1,517,-37.7638,145.0182,1275000,2248000,508318464,973000,507043464
3,1,242,-37.7639,145.0135,880000,2248000,290983392,1368000,290103392
2,2,158,-37.7587,144.9881,960000,2248000,224809104,1288000,223849104
2,1,317,-37.7606,144.9995,1260000,2248000,348880608,988000,347620608
2,1,330,-37.7629,145.0165,1100000,2248000,359165184,1148000,358065184
4,2,780,-37.7308,145.0932,1155000,2248000,719168768,1093000,718013768
5,1,545,-37.705,145.0825,826000,2248000,533211872,1422000,532385872
4,1,696,-37.7054,145.0809,761000,2248000,651179840,1487000,650418840
4,2,585,-37.7154,145.0777,932500,2248000,565049152,1315500,564116652
4,2,523,-37.798,144.8728,1435000,2248000,515934240,813000,514499240
2,1,0,-37.8088,144.8715,470000,835500,98282760,365500,97812760
2,1,2701,-37.8109,144.8684,502000,2248000,2232878336,1746000,2232376336
3,1,183,-37.7968,144.8708,580000,2248000,244271776,1668000,243691776
4,1,528,-37.7969,144.8647,970000,2248000,518287328,1278000,517317328
4,2,525,-37.7994,144.8763,1325000,2248000,517517184,923000,516192184
2,1,1059,-37.8062,144.8665,266000,2248000,935205760,1982000,934939760
2,1,401,-37.7903,144.8703,888000,2248000,415189632,1360000,414301632
3,1,325,-37.7922,144.8818,935000,2248000,356500448,1313000,355565448
4,2,450,-37.861,144.8985,2165000,2248000,458265632,83000,456100632
3,2,292,-37.8575,144.8922,1245000,2248000,332027936,1003000,330782936
4,3,324,-37.8622,144.8884,2075000,2248000,360275232,173000,358200232
2,1,0,-37.8536,144.8981,543000,835500,98304400,292500,97761400
3,1,308,-37.8526,144.895,1150000,2248000,343080608,1098000,341930608
5,3,531,-37.8629,144.8781,2040000,2248000,525227008,208000,523187008
2,1,0,-37.8589,144.8921,465000,835500,98301328,370500,97836328
2,1,0,-37.8685,144.9058,550000,835500,98310896,285500,97760896
4,3,183,-37.8566,144.8737,1200000,2248000,248833344,1048000,247633344
3,1,340,-37.8227,144.8827,990000,2248000,368359104,1258000,367369104
4,2,607,-37.8128,144.8905,2035000,2248000,582331968,213000,580296968
3,1,198,-37.8194,144.8914,935000,2248000,256141632,1313000,255206632
3,1,449,-37.8195,144.8766,892000,2248000,454497472,1356000,453605472
4,1,445,-37.8228,144.8769,985500,2248000,452703072,1262500,451717572
2,2,0,-37.8161,144.8967,650000,835500,99892400,185500,99242400
2,1,0,-37.8128,144.8953,397000,835500,98297880,438500,97900880
2,1,304,-37.8122,144.8671,650000,2248000,338531264,1598000,337881264
3,2,390,-37.8227,144.8955,750000,2248000,409475200,1498000,408725200
3,2,354,-37.8212,144.8937,970000,2248000,381023136,1278000,380053136
2,1,531,-37.8158,144.8707,1256000,2248000,517931744,992000,516675744
3,2,152,-37.811,144.8889,1120000,2248000,221378608,1128000,220258608
3,3,305,-37.8149,144.8942,1425000,2248000,343891328,823000,342466328
3,1,189,-37.8145,144.8808,872500,2248000,249021840,1375500,248149340
4,1,328,-37.8097,144.8906,1455000,2248000,360245056,793000,358790056
1,1,0,-37.8105,144.8952,331000,835500,96931336,504500,96600336
3,2,287,-37.8233,144.8825,950000,2248000,328066464,1298000,327116464
3,1,198,-37.8025,144.9939,1000000,2248000,256202704,1248000,255202704
2,2,0,-37.8055,144.9961,870000,835500,99952328,-34500,99082328
2,1,129,-37.8099,145.0027,1050000,2248000,200312176,1198000,199262176
2,1,249,-37.8052,144.9963,1242000,2248000,295143552,1006000,293901552
3,2,92,-37.797,144.9957,1165000,2248000,174024752,1083000,172859752
3,2,305,-37.7284,144.8874,720000,2248000,342283680,1528000,341563680
3,1,488,-37.7191,144.8857,510000,2248000,485312960,1738000,484802960
2,1,128,-37.7216,144.8837,480000,2248000,199438256,1768000,198958256
3,2,689,-37.7776,144.8167,800000,2248000,645720704,1448000,644920704
2,1,192,-37.7832,144.8275,420000,2248000,249990032,1828000,249570032
3,2,250,-37.7798,144.8156,580000,2248000,298779136,1668000,298199136
1,1,1175,-37.7849,144.8272,200000,2248000,1025487552,2048000,1025287552
3,1,181,-37.7815,144.8128,600000,2248000,242653712,1648000,242053712
5,3,725,-37.8712,144.8107,1480000,2248000,678504448,768000,677024448
4,3,480,-37.8726,145.0716,2220000,2248000,483675776,28000,481455776
3,3,329,-37.8101,145.0844,1680000,2248000,362975008,568000,361295008
2,1,780,-37.8241,144.8419,1005000,2248000,714699392,1243000,713694392
2,2,0,-37.7947,144.9724,960000,835500,99936472,-124500,98976472
2,2,0,-37.7973,144.9712,995000,835500,99936048,-159500,98941048
1,1,0,-37.7998,144.9689,490000,835500,96975432,345500,96485432
4,2,707,-37.762,145.0645,1750000,2248000,661462976,498000,659712976
3,2,114,-37.8857,145.0011,850000,2248000,191425088,1398000,190575088
2,1,0,-37.8881,145.0097,740000,835500,98377152,95500,97637152
2,1,0,-37.8817,145.0032,632500,835500,98372376,203000,97739876
2,2,626,-37.8865,144.9874,1260000,2248000,594683520,988000,593423520
1,1,0,-37.8749,144.9799,360000,835500,96991032,475500,96631032
3,2,362,-37.8772,144.9904,1520000,2248000,387411648,728000,385891648
2,2,0,-37.8857,144.9884,800000,835500,99957016,35500,99157016
2,1,0,-37.8777,144.9891,500000,835500,98363240,335500,97863240
1,1,0,-37.8852,144.9877,490000,835500,96997048,345500,96507048
4,2,521,-37.7372,144.9022,1291000,2248000,514364640,957000,513073640
2,2,81,-37.7976,144.9778,1100000,2248000,163954336,1148000,162854336
2,1,6261,-37.799,144.975,1350000,2248000,5046406144,898000,5045056144
2,1,131,-37.7999,144.9776,1350000,2248000,201876128,898000,200526128
3,2,277,-37.7039,144.8986,680000,2248000,320159328,1568000,319479328
4,2,702,-37.7071,144.8989,990000,2248000,657403008,1258000,656413008
4,2,737,-37.7088,144.8938,970000,2248000,685060608,1278000,684090608
3,1,630,-37.6822,144.9108,485000,2248000,597546496,1763000,597061496
3,2,650,-37.724,144.8514,773000,2248000,614914048,1475000,614141048
1,1,0,-37.7886,144.9253,425000,835500,96947288,410500,96522288
2,2,2592,-37.7961,144.9261,535000,2248000,2148362752,1713000,2147827752
2,1,0,-37.7897,144.9228,500000,835500,98312088,335500,97812088
2,1,0,-37.7912,144.9318,525000,835500,98317792,310500,97792792
3,1,98,-37.791,144.9323,917500,2248000,177133568,1330500,176216068
3,1,0,-37.7954,144.9259,902500,835500,99680872,-67000,98778372
2,1,132,-37.8527,144.9657,1300000,2248000,202665328,948000,201365328
3,2,148,-37.8496,144.963,2250000,2248000,218267568,-2000,216017568
2,1,179,-37.9369,145.0473,742500,2248000,239869488,1505500,239126988
3,1,601,-37.9409,145.0602,860000,2248000,574750144,1388000,573890144
3,2,230,-37.7987,144.9434,2161000,2248000,283053984,87000,280892984
3,1,198,-37.8029,144.9459,1485000,2248000,256173216,763000,254688216
2,1,89,-37.9394,145.089,940000,2248000,168768560,1308000,167828560
3,1,590,-37.918,145.085,770000,2248000,566069504,1478000,565299504
4,2,590,-37.9316,145.0821,1410000,2248000,569028864,838000,567618864
3,1,658,-37.9176,145.0839,1042500,2248000,619809024,1205500,618766524
2,1,0,-37.8288,144.9679,595000,835500,98344440,240500,97749440
2,1,0,-37.8273,144.9685,580000,835500,98344640,255500,97764640
2,1,0,-37.8248,144.9667,580000,835500,98343232,255500,97763232
1,1,89,-37.8291,144.8848,380000,2248000,167263712,1868000,166883712
3,1,305,-37.8312,144.8893,1100000,2248000,340703712,1148000,339603712
3,1,221,-37.8297,144.8752,660000,2248000,274309696,1588000,273649696
2,1,1816,-37.8389,145.0141,655000,2248000,1533556864,1593000,1532901864
3,1,1678,-37.8384,145.0178,840000,2248000,1425863808,1408000,1425023808
2,2,586,-37.8427,145.0236,1010000,2248000,563088704,1238000,562078704
3,2,3,-37.8474,145.0125,1320000,2248000,103704440,928000,102384440
3,2,146,-37.857,144.8846,670000,2248000,216639568,1578000,215969568
3,2,442,-37.8538,144.8722,1070000,2248000,450560032,1178000,449490032
3,1,860,-37.8565,144.8865,1575000,2248000,779320768,673000,777745768
3,2,146,-37.857,144.8846,720000,2248000,216639568,1528000,215919568
3,2,526,-37.855,144.8742,1045000,2248000,516946496,1203000,515901496
2,1,0,-37.8559,144.999,585000,835500,98366768,250500,97781768
2,1,774,-37.8582,144.9979,854000,2248000,710057600,1394000,709203600
1,1,0,-37.8508,144.984,350000,835500,96990728,485500,96640728
5,2,627,-37.7327,145.0804,1060000,2248000,599611648,1188000,598551648
2,1,0,-37.8656,144.9919,450000,835500,98363536,385500,97913536
3,1,260,-37.7157,145.0386,488000,2248000,305218560,1760000,304730560
2,2,0,-37.8094,144.9452,1013000,835500,99921464,-177500,98908464
2,1,0,-37.7847,144.9383,360000,835500,98321040,475500,97961040
3,1,219,-37.71655,144.88155,640000,2248000,272719712,1608000,272079712
3,1,423,-37.77917,144.82223,570000,2248000,433911520,1678000,433341520
3,1,672,-37.8265,144.84386,900000,2248000,630714816,1348000,629814816
3,2,226,-37.79495,145.08192,1275000,2248000,279977664,973000,278702664
3,2,187,-37.83909,145.26075,640000,2248000,249271248,1608000,248631248
3,1,401,-37.92999,145.04932,1045000,2248000,416682400,1203000,415637400
5,2,611,-37.93228,145.07026,1220000,2248000,586984064,1028000,585764064
3,1,509,-37.70822,145.11495,840000,2248000,502049056,1408000,501209056
3,2,645,-37.90876,145.00743,2650000,2248000,611080320,-402000,608430320
1,1,1993,-37.88468,144.99722,380000,2248000,1672068352,1868000,1671688352
4,3,345,-37.91503,145.00888,1731000,2248000,376951840,517000,375220840
3,2,248,-37.68358,144.92387,465000,2248000,297253856,1783000,296788856
3,1,576,-37.69237,144.93144,518500,2248000,554884288,1729500,554365788
3,2,472,-37.7331,144.76282,535000,2248000,474187456,1713000,473652456
3,2,397,-37.75107,144.78415,630000,2248000,414930304,1618000,414300304
2,1,131,-37.84716,145.07351,677000,2248000,201940736,1571000,201263736
3,2,227,-37.84689,145.05863,1320000,2248000,280759712,928000,279439712
2,2,8140,-37.82091,145.06011,816000,2248000,6533025280,1432000,6532209280
1,1,0,-37.79859,144.97336,350000,835500,96978040,485500,96628040
3,3,160,-37.96062,145.04296,950000,2248000,229406688,1298000,228456688
2,1,350,-37.74483,144.97269,900000,2248000,374942080,1348000,374042080
4,2,463,-37.73704,144.97959,922000,2248000,468574848,1326000,467652848
4,2,756,-37.58885,144.90135,665000,2248000,700066880,1583000,699401880
3,1,651,-37.60329,144.93948,515500,2248000,614151168,1732500,613635668
3,2,618,-37.59715,144.89656,660000,2248000,589637440,1588000,588977440
4,2,880,-37.79587,145.2683,932000,2248000,798314112,1316000,797382112
2,1,312,-37.80752,145.27212,570000,2248000,345102400,1678000,344532400
3,1,610,-37.96322,145.20586,627000,2248000,581955200,1621000,581328200
2,1,610,-37.67629,145.15589,621000,2248000,580524480,1627000,579903480
6,3,1056,-37.78053,145.15567,1856000,2248000,941661248,392000,939805248
7,2,5022,-37.76598,145.19329,2705000,2248000,4075780608,-457000,4073075608
3,2,400,-37.61042,145.11932,530500,2248000,417490944,1717500,416960444
3,2,848,-37.70913,145.1647,805000,2248000,771584384,1443000,770779384
4,3,508,-37.62693,145.01563,940000,2248000,505740864,1308000,504800864
2,1,351,-37.65099,145.04663,437000,2248000,375766912,1811000,375329912
1,1,0,-37.75121,144.91326,291000,835500,96935480,544500,96644480
3,1,236,-37.75403,144.8867,750000,2248000,286162368,1498000,285412368
5,3,607,-37.75148,144.88519,2200000,2248000,585281024,48000,583081024
2,1,184,-37.78493,144.98879,1350000,2248000,243767120,898000,242417120
3,2,138,-37.78714,144.97966,1852000,2248000,210367504,396000,208515504
1,1,30,-37.80141,144.89587,170000,2248000,120639648,2078000,120469648
3,2,691,-38.11948,145.14928,611000,2248000,647546176,1637000,646935176
3,1,786,-38.16492,145.12656,755000,2248000,721022720,1493000,720267720
4,2,978,-37.49642,144.60119,521000,2248000,875317568,1727000,874796568
2,1,0,-37.85399,145.04699,500000,835500,98396088,335500,97896088
3,1,194,-37.70168,144.94862,525000,2248000,253001808,1723000,252476808
2,2,208,-37.70267,145.09526,695000,2248000,264383424,1553000,263688424
3,2,9838,-37.93464,144.99601,1210000,2248000,7876293632,1038000,7875083632
3,1,1079,-37.82987,145.03421,1000000,2248000,952483968,1248000,951483968
4,1,636,-37.81931,145.04107,2900000,2248000,603750784,-652000,600850784
2,1,1540,-37.82824,145.03137,450000,2248000,1315443584,1798000,1314993584
3,2,724,-37.64685,145.52635,650000,2248000,673802560,1598000,673152560
3,1,593,-37.7482,145.04073,726500,2248000,568393152,1521500,567666652
2,1,105,-37.94887,145.02647,645000,2248000,181375952,1603000,180730952
5,2,615,-37.68455,144.73272,650500,2248000,589908416,1597500,589257916
3,2,321,-37.90415,145.10504,750000,2248000,355083104,1498000,354333104
4,1,692,-37.6876,144.91167,650000,2248000,647912384,1598000,647262384
2,1,165,-37.68582,144.91638,390000,2248000,228695232,1858000,228305232
3,2,749,-37.72321,144.80882,735000,2248000,693127424,1513000,692392424
2,2,62,-37.73893,144.87661,520000,2248000,148869488,1728000,148349488
3,2,0,-37.79482,144.92192,967000,835500,101271632,-131500,100304632
2,1,0,-37.79122,144.93175,535000,835500,98317776,300500,97782776
2,1,1011,-37.7972,145.05225,862000,2248000,897384768,1386000,896522768
4,1,680,-37.9865,145.16767,761000,2248000,638621568,1487000,637860568
3,1,532,-37.731,144.77387,530000,2248000,520018720,1718000,519488720
4,2,544,-37.66747,144.98802,750000,2248000,532586112,1498000,531836112
1,1,3826,-37.77757,144.87232,280000,2248000,3120596480,1968000,3120316480
3,2,262,-37.78284,144.88098,895000,2248000,308303296,1353000,307408296
4,2,547,-37.69026,144.57866,320000,2248000,534707648,1928000,534387648
3,1,900,-37.68738,144.57415,480000,2248000,810720576,1768000,810240576
4,2,512,-37.58676,145.08889,670000,2248000,507349120,1578000,506679120
2,1,241,-37.67231,145.05878,460000,2248000,288843968,1788000,288383968
3,1,608,-37.82583,145.20608,950000,2248000,580358592,1298000,579408592
3,2,263,-37.8179,145.20658,970000,2248000,309298144,1278000,308328144
3,2,382,-37.72857,145.12728,655000,2248000,403284384,1593000,402629384
3,2,402,-37.87389,145.12783,1205000,2248000,419107776,1043000,417902776
3,1,807,-37.86618,145.14757,1385000,2248000,737596800,863000,736211800
3,1,1028,-37.89757,145.11825,2000000,2248000,912238464,248000,910238464
2,1,120,-37.84026,144.86667,710000,2248000,193119344,1538000,192409344
4,2,596,-37.80827,145.18099,1100000,2248000,573816896,1148000,572716896
2,1,182,-37.712,144.91761,610000,2248000,242134128,1638000,241524128
1,1,1006,-37.90164,145.04139,454000,2248000,892072576,1794000,891618576
2,1,0,-37.90286,145.04772,562000,835500,98402272,273500,97840272
3,2,298,-37.99464,145.08099,1000000,2248000,336902080,1248000,335902080
5,3,681,-37.72565,144.94954,1501000,2248000,643799616,747000,642298616
4,2,555,-37.71561,144.94336,780000,2248000,541257472,1468000,540477472
5,2,571,-37.89467,144.72018,660000,2248000,555152192,1588000,554492192
4,3,210,-37.83933,144.93771,2450000,2248000,270208800,-202000,267758800
3,1,614,-37.71562,145.02175,840000,2248000,584973952,1408000,584133952
2,2,138,-37.72487,145.00705,668500,2248000,209010832,1579500,208342332
2,2,180,-37.81443,144.99079,890500,2248000,242203888,1357500,241313388
5,2,733,-37.91894,145.24305,870000,2248000,683505216,1378000,682635216
2,1,0,-37.95236,145.00737,643500,835500,98383256,192000,97739756
3,2,264,-38.10422,145.14159,572000,2248000,310082080,1676000,309510080
2,1,152,-37.80697,144.8928,850000,2248000,218421072,1398000,217571072
4,2,505,-37.61957,145.0948,600000,2248000,501824544,1648000,501224544
3,1,623,-37.94106,145.16193,752500,2248000,592199360,1495500,591446860
3,1,614,-37.73074,144.78925,565000,2248000,584832576,1683000,584267576
3,1,563,-37.7627,144.81107,610000,2248000,544544576,1638000,543934576
1,1,0,-37.8614,144.97407,350000,835500,96985856,485500,96635856
2,1,0,-37.87174,144.98286,525000,835500,98358696,310500,97833696
1,1,980,-37.85954,144.98869,517500,2248000,871487488,1730500,870969988
2,1,881,-37.86476,144.97826,365000,2248000,794608256,1883000,794243256
4,2,613,-37.59501,144.70069,580000,2248000,586931264,1668000,586351264
3,1,466,-37.57282,144.70553,420000,2248000,467798272,1828000,467378272
3,1,841,-37.83729,145.10929,2100000,2248000,764440000,148000,762340000
3,2,407,-37.83867,144.7034,526000,2248000,422793920,1722000,422267920
4,2,724,-37.71071,144.74962,605500,2248000,674698240,1642500,674092740
5,4,968,-37.77083,145.11516,1705000,2248000,872315968,543000,870610968
4,3,530,-37.76281,145.01986,2070000,2248000,523145952,178000,521075952
3,2,331,-37.73298,145.08894,905000,2248000,362956064,1343000,362051064
3,2,658,-37.88688,144.67244,510000,2248000,621145472,1738000,620635472
3,1,422,-37.79644,144.86388,845000,2248000,433148896,1403000,432303896
3,1,743,-37.89757,144.63041,480000,2248000,686703040,1768000,686223040
2,1,0,-37.75571,144.90366,507000,835500,98296320,328500,97789320
3,2,165,-37.84152,144.95027,2500000,2248000,231693872,-252000,229193872
3,1,716,-37.77917,144.81407,787000,2248000,665464000,1461000,664677000
4,2,580,-37.77227,145.0284,2220000,2248000,561074048,28000,558854048
3,1,256,-37.85911,145.01783,2385000,2248000,302061408,-137000,299676408
3,3,382,-37.77206,144.90397,1500000,2248000,404745312,748000,403245312
4,3,510,-37.87159,145.0795,1655000,2248000,507389504,593000,505734504
4,2,604,-37.86513,145.07919,2405000,2248000,580083456,-157000,577678456
5,2,992,-37.84613,145.25606,930000,2248000,888192128,1318000,887262128
3,2,509,-37.84823,145.26673,700000,2248000,503752192,1548000,503052192
4,3,304,-37.8543,145.25253,860000,2248000,344692448,1388000,343832448
2,1,633,-37.98489,145.04116,1470000,2248000,598666944,778000,597196944
4,2,293,-37.92594,145.03184,1200000,2248000,334278400,1048000,333078400
4,2,426,-37.91657,145.05534,1620000,2248000,439401536,628000,437781536
4,2,604,-37.91327,145.07917,1580000,2248000,580089024,668000,578509024
4,3,696,-37.81726,145.16061,1695000,2248000,654428608,553000,652733608
3,2,407,-38.06257,145.1226,836000,2248000,423078208,1412000,422242208
4,2,820,-37.87393,145.28858,780000,2248000,750917760,1468000,750137760
4,1,730,-37.87377,145.28688,783000,2248000,678196608,1465000,677413608
2,1,318,-37.70688,145.11791,637000,2248000,349737472,1611000,349100472
3,1,284,-37.91155,145.00657,1175000,2248000,324189024,1073000,323014024
3,2,385,-37.91068,145.00394,1935000,2248000,405600736,313000,403665736
5,3,645,-37.91818,145.01513,2000000,2248000,615411904,248000,613411904
3,2,251,-37.77588,144.95736,1435000,2248000,299656224,813000,298221224
2,1,234,-37.77539,144.95576,1315000,2248000,283260608,933000,281945608
2,1,61,-37.766,144.96076,700000,2248000,146540880,1548000,145840880
2,1,240,-37.75697,144.95543,920000,2248000,288000032,1328000,287080032
2,2,77,-37.7617,144.96406,765000,2248000,160780464,1483000,160015464
4,1,678,-37.75967,144.97214,1400000,2248000,636894016,848000,635494016
2,1,173,-37.77524,144.97529,1105000,2248000,235064384,1143000,233959384
4,2,599,-37.848,145.14165,1032000,2248000,576168256,1216000,575136256
4,2,638,-37.76189,144.78517,821000,2248000,606760384,1427000,605939384
2,1,116,-37.82012,145.08526,850000,2248000,190090304,1398000,189240304
3,2,602,-37.90248,145.05943,1570000,2248000,577128832,678000,575558832
3,2,750,-37.90092,145.04924,1275000,2248000,694086592,973000,692811592
3,2,430,-37.90008,145.06187,1435000,2248000,441198592,813000,439763592
3,1,406,-37.72484,144.74296,600000,2248000,420421312,1648000,419821312
2,1,199,-38.07938,145.13227,529000,2248000,255744528,1719000,255215528
4,2,633,-38.0781,145.12429,845000,2248000,603054720,1403000,602209720
2,2,0,-37.88776,145.03364,650000,835500,99985112,185500,99335112
1,1,0,-37.8681,145.02576,350000,835500,97018456,485500,96668456
2,1,0,-37.86827,145.02113,665000,835500,98381848,170500,97716848
2,1,218,-37.88093,145.10574,674000,2248000,270720512,1574000,270046512
3,2,534,-38.04683,145.1261,840000,2248000,523446464,1408000,522606464
2,1,359,-37.96342,145.06516,745000,2248000,382137376,1503000,381392376
3,1,605,-37.97161,145.07036,1240000,2248000,577921216,1008000,576681216
2,1,0,-37.96021,145.05938,850000,835500,98416192,-14500,97566192
3,1,725,-37.91865,145.14341,1300000,2248000,672795904,948000,671495904
3,1,64,-37.75535,144.96481,690000,2248000,150279232,1558000,149589232
3,2,737,-37.75107,144.95112,1600000,2248000,683734656,648000,682134656
3,1,479,-37.73251,144.98178,690000,2248000,478260992,1558000,477570992
2,2,108,-37.79531,144.9863,1025000,2248000,185297360,1223000,184272360
4,2,480,-37.57201,144.90897,667000,2248000,481947104,1581000,481280104
3,1,624,-37.97806,145.20432,678000,2248000,593020160,1570000,592342160
3,1,530,-37.96006,145.22094,595000,2248000,518740160,1653000,518145160
2,1,141,-37.95431,145.20899,305000,2248000,209939696,1943000,209634696
3,2,533,-37.986,145.12035,816000,2248000,522645472,1432000,521829472
4,4,1072,-37.79094,145.12733,2600000,2248000,953150656,-352000,950550656
3,1,647,-37.79436,145.13869,1360000,2248000,611135040,888000,609775040
5,2,757,-37.77536,145.13163,1600000,2248000,702387008,648000,700787008
4,2,785,-37.7738,145.16712,1662000,2248000,723170816,586000,721508816
3,1,700,-37.99095,145.2316,545000,2248000,653101184,1703000,652556184
2,1,112,-37.76689,145.05206,750000,2248000,186902432,1498000,186152432
2,1,1764,-37.8879,145.01198,975000,2248000,1492465664,1273000,1491490664
2,1,1210,-37.8785,144.99316,480000,2248000,1054627328,1768000,1054147328
2,1,0,-37.88094,144.99471,696750,835500,98367064,138750,97670314
1,1,1192,-37.88306,144.9841,420000,2248000,1039030848,1828000,1038610848
2,1,887,-37.88349,144.98699,695500,2248000,799357632,1552500,798662132
3,1,699,-37.65105,145.04613,540000,2248000,652156736,1708000,651616736
3,1,606,-37.64954,145.03648,620000,2248000,578652864,1628000,578032864
3,2,203,-37.75582,144.91061,1025000,2248000,261690752,1223000,260665752
3,2,276,-37.75126,144.89558,1320000,2248000,319372736,928000,318052736
5,3,590,-37.75511,144.90935,2210000,2248000,571861248,38000,569651248
3,2,400,-37.71693,144.96527,700000,2248000,417408672,1548000,416708672
3,1,603,-37.70037,144.97007,712000,2248000,576247040,1536000,575535040
3,1,621,-37.71193,144.974,775000,2248000,590476224,1473000,589701224
3,1,593,-38.15517,145.12705,700000,2248000,568494144,1548000,567794144
3,1,624,-38.1187,145.14973,452000,2248000,593003072,1796000,592551072
3,1,554,-37.84949,145.07726,1890000,2248000,537605952,358000,535715952
4,1,655,-37.87173,145.15267,1750000,2248000,618841344,498000,617091344
2,1,258,-37.88245,145.15982,1100000,2248000,302365984,1148000,301265984
3,1,649,-37.69777,144.91952,695000,2248000,612569344,1553000,611874344
3,2,610,-37.71437,145.10112,817000,2248000,583454784,1431000,582637784
3,2,650,-37.64049,144.8846,680000,2248000,614924736,1568000,614244736
5,3,1750,-37.65439,144.89113,1170000,2248000,1488584832,1078000,1487414832
5,4,602,-37.65039,144.89948,830000,2248000,582919616,1418000,582089616
3,1,676,-37.70328,144.94161,827000,2248000,633921728,1421000,633094728
3,2,0,-37.70903,144.93995,627000,835500,101272648,208500,100645648
3,1,1396,-37.81415,145.03082,690000,2248000,1203004928,1558000,1202314928
2,1,2267,-37.82193,145.01749,1022000,2248000,1889981824,1226000,1888959824
5,2,820,-37.83031,145.02973,5510000,2248000,752119552,-3262000,746609552
4,2,371,-37.81474,145.02609,3335000,2248000,395905120,-1087000,392570120
1,1,0,-37.82694,145.03094,560000,835500,97016816,275500,96456816
2,1,0,-37.82258,145.0193,805000,835500,98375352,30500,97570352
3,2,282,-37.82911,145.04531,1875000,2248000,324215840,373000,322340840
4,2,528,-37.83539,145.0431,2320000,2248000,519994976,-72000,517674976
3,2,265,-37.84506,145.05246,1465000,2248000,310787040,783000,309322040
3,2,173,-37.8327,145.2348,701000,2248000,238190352,1547000,237489352
3,1,592,-37.73736,145.05603,885000,2248000,567611008,1363000,566726008
3,2,453,-37.68811,144.74999,485000,2248000,459158592,1763000,458673592
3,2,557,-37.87498,144.69617,555500,2248000,541338560,1692500,540783060
3,2,0,-37.75822,145.05056,910000,835500,101346504,-74500,100436504
3,2,334,-37.76538,145.04964,1300000,2248000,365306560,948000,364006560
3,2,805,-37.7714,145.05963,2525000,2248000,737544192,-277000,735019192
3,1,647,-37.72544,144.85259,670000,2248000,610950784,1578000,610280784
2,1,165,-37.7902,144.93192,990000,2248000,228717040,1258000,227727040
2,1,0,-37.81439,145.04237,942000,835500,98388576,-106500,97446576
1,1,0,-37.80468,145.03614,515000,835500,97017392,320500,96502392
4,2,794,-37.79172,145.05863,2162000,2248000,730218816,86000,728056816
3,2,753,-37.79017,145.06381,2260000,2248000,696453376,-12000,694193376
4,2,624,-37.9887,145.16158,745000,2248000,595954560,1503000,595209560
4,1,467,-37.7126,145.02996,800001,2248000,470170912,1447999,469370911
3,1,589,-37.67056,145.03698,521000,2248000,565220608,1727000,564699608
2,1,0,-37.86824,145.03504,592000,835500,98390400,243500,97798400
3,2,580,-37.8683,145.03909,1780000,2248000,559725568,468000,557945568
2,2,37000,-37.77518,144.89254,585000,2248000,29340940288,1663000,29340355288
4,2,238,-37.7833,144.89717,1085000,2248000,290712352,1163000,289627352
4,2,766,-37.69791,144.5807,355000,2248000,707785344,1893000,707430344
5,2,666,-37.67523,144.55833,355000,2248000,630105152,1893000,629750152
2,1,0,-37.98937,145.06723,800000,835500,98424448,35500,97624448
3,1,530,-37.97584,145.08107,885000,2248000,518655904,1363000,517770904
3,1,207,-37.85356,144.96415,2010000,2248000,263303088,238000,261293088
6,4,472,-37.85231,144.96373,5600000,2248000,481610304,-3352000,476010304
4,2,808,-37.67348,145.06982,732000,2248000,741276032,1516000,740544032
4,2,649,-37.67681,145.06414,720000,2248000,615615360,1528000,614895360
3,1,526,-37.67561,145.05641,556500,2248000,515444288,1691500,514887788
3,2,596,-37.76086,144.90497,1850000,2248000,572275328,398000,570425328
2,1,251,-37.76856,144.90577,760000,2248000,296664096,1488000,295904096
5,2,1254,-37.79026,145.33738,872000,2248000,1095293952,1376000,1094421952
3,2,947,-37.76517,145.3298,730000,2248000,849932160,1518000,849202160
4,2,312,-38.002,145.08916,1170000,2248000,349338336,1078000,348168336
3,2,297,-37.8605,145.12853,1011000,2248000,336125248,1237000,335114248
4,2,650,-37.74103,144.88496,1337000,2248000,616302976,911000,614965976
2,1,102,-37.79489,144.94207,970000,2248000,178935024,1278000,177965024
4,2,697,-37.72001,144.91683,1138000,2248000,653464192,1110000,652326192
2,1,703,-37.90241,145.12378,1114000,2248000,654029120,1134000,652915120
3,1,211,-37.89941,145.11523,740000,2248000,266562688,1508000,265822688
4,2,564,-37.93543,145.08408,1120000,2248000,548482688,1128000,547362688
1,1,821,-37.90296,145.04637,280000,2248000,745870528,1968000,745590528
2,1,0,-37.90335,145.03718,485000,835500,98395848,350500,97910848
3,2,627,-37.99544,145.08727,1315000,2248000,596914304,933000,595599304
3,2,2431,-37.78212,144.95755,1770000,2248000,2022508416,478000,2020738416
3,2,0,-37.8429,144.94487,1725000,835500,101291408,-889500,99566408
2,2,1472,-37.84096,144.93791,665000,2248000,1263240448,1583000,1262575448
3,2,145,-37.84957,144.9889,1400000,2248000,215912592,848000,214512592
5,2,558,-37.73472,144.99658,1400000,2248000,545029632,848000,543629632
4,1,540,-37.73935,145.01517,830000,2248000,527856768,1418000,527026768
3,1,470,-37.73912,145.01298,881000,2248000,471168288,1367000,470287288
3,1,349,-37.74946,145.00875,945000,2248000,375540768,1303000,374595768
3,2,515,-37.74794,144.99111,1210000,2248000,508312544,1038000,507102544
3,1,590,-37.73314,145.03437,725000,2248000,566016576,1523000,565291576
3,1,448,-37.73443,145.00201,972500,2248000,453774400,1275500,452801900
3,1,263,-37.74739,145.00934,955000,2248000,307575168,1293000,306620168
3,1,204,-37.78251,144.96817,1900000,2248000,260926352,348000,259026352
2,1,0,-37.7106,145.00177,521000,835500,98351400,314500,97830400
3,1,325,-37.72589,144.99681,857700,2248000,356563456,1390300,355705756
3,2,160,-37.71064,145.01067,642500,2248000,227764144,1605500,227121644
2,1,407,-37.82046,144.99398,575000,2248000,420011072,1673000,419436072
4,1,669,-37.81656,145.24247,910000,2248000,629954304,1338000,629044304
4,1,833,-37.81186,145.25419,1200000,2248000,759569920,1048000,758369920
3,2,255,-37.63382,144.92774,425000,2248000,302782496,1823000,302357496
4,2,604,-37.95326,145.01779,2300000,2248000,580055936,-52000,577755936
3,2,398,-37.94785,145.01467,1710000,2248000,415885600,538000,414175600
4,2,381,-37.95372,145.00608,2221000,2248000,403812128,27000,401591128
3,1,531,-37.87793,144.75626,515000,2248000,519234816,1733000,518719816
3,1,648,-38.11014,145.14336,540000,2248000,611965312,1708000,611425312
3,2,663,-37.8642,144.84257,1360000,2248000,625199040,888000,623839040
3,1,198,-37.80779,144.88887,1180000,2248000,256138688,1068000,254958688
3,2,334,-37.83137,144.86731,790000,2248000,365202112,1458000,364412112
2,1,1646,-37.83406,144.97131,530000,2248000,1399179008,1718000,1398649008
4,3,624,-37.63485,145.07272,915000,2248000,597451520,1333000,596536520
3,2,492,-37.64215,145.08584,644000,2248000,490181600,1604000,489537600
5,5,700,-37.6236,145.10629,905000,2248000,662086336,1343000,661181336
2,2,0,-37.84712,144.99967,800000,835500,99959416,35500,99159416
2,2,187,-37.83554,144.97956,2210000,2248000,247731536,38000,245521536
3,1,136,-37.84497,144.99781,1400000,2248000,207211568,848000,205811568
2,1,0,-37.84468,145.00368,535000,835500,98368336,300500,97833336
1,1,63,-37.83014,144.96967,422000,2248000,146768304,1826000,146346304
2,2,213,-37.73519,144.92374,790000,2248000,268233168,1458000,267443168
3,2,600,-37.57686,144.71023,410000,2248000,575294976,1838000,574884976
2,1,193,-37.83275,145.1055,740000,2248000,250957264,1508000,250217264
3,2,666,-37.71594,144.7415,680000,2248000,627490304,1568000,626810304
3,2,809,-37.75289,145.12826,1350000,2248000,740745408,898000,739395408
4,3,332,-37.76577,145.10729,1010000,2248000,366720992,1238000,365710992
3,2,545,-37.68403,144.99246,740000,2248000,532014848,1508000,531274848
2,1,0,-37.75257,145.00279,493000,835500,98356960,342500,97863960
4,1,495,-37.75231,144.99023,1626000,2248000,492279520,622000,490653520
1,1,0,-37.83732,145.01164,550000,835500,97006152,285500,96456152
2,1,713,-37.84301,145.02641,682000,2248000,661865216,1566000,661183216
4,2,0,-37.83368,145.20409,975000,835500,102816064,-139500,101841064
3,2,277,-37.83581,145.19802,820000,2248000,320359136,1428000,319539136
3,2,253,-37.7004,145.09033,655000,2248000,301309792,1593000,300654792
3,1,700,-37.89363,144.65693,472000,2248000,652736064,1776000,652264064
3,2,268,-37.89347,144.66679,467000,2248000,312926272,1781000,312459272
3,1,530,-37.90111,144.63302,390000,2248000,518371392,1858000,517981392
3,2,342,-37.79369,144.87511,1155000,2248000,371524896,1093000,370369896
3,2,380,-37.79194,144.87144,1100000,2248000,401553760,1148000,400453760
3,1,532,-37.67949,144.88349,540000,2248000,520080096,1708000,519540096
4,2,800,-37.92024,145.18049,1171000,2248000,735050752,1077000,733879752
4,2,448,-37.86409,144.88224,1900000,2248000,456675424,348000,454775424
5,3,617,-37.71992,145.0988,1670000,2248000,593311744,578000,591641744
2,1,150,-37.81956,144.89054,950000,2248000,216840560,1298000,215890560
2,1,601,-37.80915,145.00066,480000,2248000,573331840,1768000,572851840
2,1,2379,-37.80554,144.99612,750000,2248000,1978480000,1498000,1977730000
3,1,242,-37.72893,144.88859,730000,2248000,290902400,1518000,290172400
4,2,604,-37.77967,144.81275,820000,2248000,579909376,1428000,579089376
3,2,284,-37.86066,144.82013,670000,2248000,325661568,1578000,324991568
3,2,200,-37.86837,144.81502,765000,2248000,259274240,1483000,258509240
3,1,559,-37.8399,144.86228,870000,2248000,541424000,1378000,540554000
4,4,847,-37.85938,145.01087,3200000,2248000,775269824,-952000,772069824
4,2,360,-37.77459,144.92993,1750000,2248000,387147968,498000,385397968
4,3,726,-37.85842,145.10288,1680000,2248000,678106880,568000,676426880
3,2,280,-37.87105,145.10198,860000,2248000,322675072,1388000,321815072
3,1,585,-37.75986,144.85886,750000,2248000,561960192,1498000,561210192
3,2,752,-37.80648,145.08274,2380000,2248000,695676672,-132000,693296672
1,1,678,-37.80292,145.06424,2100000,2248000,632857088,148000,630757088
4,4,613,-37.81167,145.08595,3050000,2248000,590380480,-802000,587330480
3,2,292,-37.80259,145.09878,1557000,2248000,332148640,691000,330591640
4,1,1138,-37.79284,145.10082,2050000,2248000,1000514432,198000,998464432
2,1,418,-37.83777,145.26345,520000,2248000,428872288,1728000,428352288
4,1,993,-37.84688,145.25632,925000,2248000,886023168,1323000,885098168
3,2,586,-37.82273,145.27323,616000,2248000,564606208,1632000,563990208
4,4,673,-37.91888,145.04775,2700000,2248000,637787456,-452000,635087456
3,1,581,-37.9178,145.05414,1525000,2248000,558937792,723000,557412792
4,2,566,-37.91503,145.07997,1330000,2248000,550058304,918000,548728304
4,2,563,-38.05379,145.34803,608500,2248000,547868800,1639500,547260300
2,1,0,-37.96341,145.01735,879000,835500,98390696,-43500,97511696
4,2,797,-37.80755,145.1638,1280000,2248000,732656320,968000,731376320
2,1,598,-37.70681,145.11731,710500,2248000,571020800,1537500,570310300
4,3,608,-37.91777,145.01798,2100000,2248000,584806400,148000,582706400
2,1,171,-37.68489,144.9212,310000,2248000,233439872,1938000,233129872
2,1,0,-37.77002,144.97154,510000,835500,98339784,325500,97829784
3,1,479,-37.77694,144.96669,1925000,2248000,478256928,323000,476331928
2,1,138,-37.75908,144.96969,890000,2248000,207398560,1358000,206508560
4,1,318,-37.76792,144.97141,1500000,2248000,352386880,748000,350886880
1,1,406,-37.75847,144.94226,312000,2248000,417815488,1936000,417503488
3,2,413,-37.76545,144.94442,1010000,2248000,427675424,1238000,426665424
4,2,300,-37.68223,145.07818,755000,2248000,339810464,1493000,339055464
3,2,207,-37.85682,145.10873,918000,2248000,264985744,1330000,264067744
5,3,844,-37.84753,145.07198,2361000,2248000,772708032,-113000,770347032
3,2,557,-37.89584,145.04741,1550000,2248000,541557184,698000,540007184
3,2,509,-38.09111,145.19084,500000,2248000,503733984,1748000,503233984
3,2,0,-37.90034,145.01283,1237000,835500,101339992,-401500,100102992
3,2,305,-37.96836,145.06452,861000,2248000,342420896,1387000,341559896
3,1,816,-37.92027,145.12937,1462000,2248000,744704576,786000,743242576
4,2,560,-37.59943,144.91439,600000,2248000,545177600,1648000,544577600
4,2,841,-37.76917,145.29265,820000,2248000,767504256,1428000,766684256
4,2,840,-37.97824,145.12949,1100000,2248000,766638208,1148000,765538208
4,2,280,-37.79423,145.13696,1120000,2248000,324053760,1128000,322933760
3,2,236,-37.78963,145.16973,850000,2248000,287934048,1398000,287084048
4,3,284,-37.79773,145.15141,1125000,2248000,328817568,1123000,327692568
3,1,118,-37.81351,144.98804,1875000,2248000,192976496,373000,191101496
2,2,87,-37.81803,144.9892,1350000,2248000,168705536,898000,167355536
3,1,377,-37.88783,145.01324,1460000,2248000,397688160,788000,396228160
2,1,1172,-37.88533,145.01049,550000,2248000,1024607488,1698000,1024057488
4,2,816,-37.72308,145.14011,1065000,2248000,747647488,1183000,746582488
4,2,1004,-37.69999,145.1617,977500,2248000,896234176,1270500,895256676
2,1,0,-37.8835,144.99549,810000,835500,98367856,25500,97557856
2,1,0,-37.88042,144.9818,543000,835500,98359064,292500,97816064
4,1,558,-37.64666,145.03062,660000,2248000,542080768,1588000,541420768
3,2,420,-37.62145,145.01051,568000,2248000,433231264,1680000,432663264
4,2,656,-37.63878,145.05577,680000,2248000,621137856,1568000,620457856
2,1,921,-37.74904,144.90668,580000,2248000,826162496,1668000,825582496
4,2,0,-37.74541,144.89844,970000,835500,102617576,-134500,101647576
2,1,337,-37.7545,144.91194,1195000,2248000,364631936,1053000,363436936
4,1,616,-37.75728,144.90723,1155000,2248000,587855168,1093000,586700168
3,2,161,-37.73566,144.89368,800000,2248000,228485376,1448000,227685376
5,2,737,-37.71729,144.96403,1018000,2248000,686471040,1230000,685453040
5,3,836,-37.8801,145.26011,1100000,2248000,766505216,1148000,765405216
3,2,60,-37.79714,144.97596,1394000,2248000,148723072,854000,147329072
1,1,1015,-37.78778,144.89037,240000,2248000,899078976,2008000,898838976
1,1,0,-37.80376,144.89862,310000,835500,96932648,525500,96622648
3,1,665,-37.48701,144.58567,540000,2248000,624983872,1708000,624443872
5,2,551,-37.68329,144.89302,691000,2248000,539427776,1557000,538736776
3,2,1590,-37.86957,145.17544,3056000,2248000,1358011520,-808000,1354955520
5,3,662,-37.87853,145.15542,2650000,2248000,628928640,-402000,626278640
3,2,0,-37.89873,145.15072,655000,835500,101424672,180500,100769672
3,2,648,-37.88255,145.14727,1550000,2248000,613534272,698000,611984272
3,1,697,-37.69795,144.94285,780000,2248000,650518144,1468000,649738144
4,1,697,-37.70159,144.93948,780000,2248000,651882688,1468000,651102688
4,2,474,-37.70626,144.89551,945000,2248000,477212832,1303000,476267832
4,2,538,-37.6499,144.9013,645000,2248000,527788896,1603000,527143896
3,2,604,-38.00305,145.2729,601000,2248000,578852608,1647000,578251608
3,2,0,-37.93538,145.00224,970000,835500,101337592,-134500,100367592
4,2,1690,-37.82652,145.03052,7650000,2248000,1438313472,-5402000,1430663472
1,1,0,-37.82538,145.02546,375000,835500,97013264,460500,96638264
2,2,6996,-37.82712,145.02427,1080000,2248000,5628902400,1168000,5627822400
5,3,572,-37.81936,145.05131,2855000,2248000,557730688,-607000,554875688
4,3,1116,-37.84283,145.05178,3255000,2248000,986290112,-1007000,983035112
4,2,264,-37.74352,145.08082,828000,2248000,311368512,1420000,310540512
4,1,630,-37.74863,145.07202,1230000,2248000,599019712,1018000,597789712
3,1,290,-37.7368,145.05048,590000,2248000,328937280,1658000,328347280
4,1,603,-37.90822,145.11146,1145000,2248000,577724736,1103000,576579736
3,1,802,-37.72343,144.81411,550000,2248000,733423296,1698000,732873296
2,2,2135,-37.79561,144.93499,730000,2248000,1787201792,1518000,1786471792
1,1,0,-37.78993,144.92306,392000,835500,96946064,443500,96554064
2,1,147,-37.79067,144.92844,1150000,2248000,214489584,1098000,213339584
4,2,199,-37.7916,144.92855,1415000,2248000,259910976,833000,258495976
5,4,769,-37.81143,145.03723,3175000,2248000,715003328,-927000,711828328
3,1,679,-37.67304,145.03397,638000,2248000,636345920,1610000,635707920
4,3,960,-37.87605,145.05563,2520000,2248000,863009792,-272000,860489792
1,1,887,-37.76878,144.89197,301000,2248000,797919488,1947000,797618488
2,1,0,-37.81317,144.95452,740000,835500,98334376,95500,97594376
4,2,642,-37.69159,144.5864,420000,2248000,609791040,1828000,609371040
3,2,435,-37.97889,145.0745,1051000,2248000,445167168,1197000,444116168
2,1,101,-37.98558,145.05966,660000,2248000,178239520,1588000,177579520
4,2,612,-37.65478,145.05199,865000,2248000,586364288,1383000,585499288
4,1,842,-37.81235,145.19756,1302000,2248000,766647872,946000,765345872
3,2,343,-37.82158,145.21129,800000,2248000,372525344,1448000,371725344
3,2,596,-37.76086,144.90497,1850000,2248000,572275328,398000,570425328
1,1,0,-37.77154,144.91597,222000,835500,96939544,613500,96717544
3,1,484,-37.78454,145.33073,581000,2248000,482433376,1667000,481852376
4,2,603,-38.00549,145.10372,1150000,2248000,579324608,1098000,578174608
4,3,708,-37.89187,145.11049,1352000,2248000,663890112,896000,662538112
4,3,720,-37.87833,145.13731,1728000,2248000,673388672,520000,671660672
4,2,726,-37.93058,145.16308,902000,2248000,676559104,1346000,675657104
3,1,627,-37.89561,145.07502,1561000,2248000,595301824,687000,593740824
3,1,646,-37.7415,144.88923,1300000,2248000,610184960,948000,608884960
3,1,390,-37.90354,145.14394,840000,2248000,408044320,1408000,407204320
5,3,766,-37.81113,145.17681,1060000,2248000,711124992,1188000,710064992
3,1,722,-37.71433,144.90616,840000,2248000,670254912,1408000,669414912
4,2,553,-37.71328,144.90585,1071888,2248000,539653568,1176112,538581680
2,2,208,-37.71679,144.90901,790000,2248000,264270448,1458000,263480448
3,2,200,-37.91017,145.11488,820000,2248000,259463696,1428000,258643696
3,1,673,-37.91693,145.08739,1218500,2248000,631665664,1029500,630447164
2,1,126,-37.90552,145.03087,695000,2248000,197969856,1553000,197274856
3,2,454,-37.99443,145.0885,940000,2248000,460193248,1308000,459253248
4,2,597,-37.99232,145.08469,1300000,2248000,574569600,948000,573269600
3,2,689,-37.73072,144.94829,1199000,2248000,645796224,1049000,644597224
3,2,104,-37.83165,144.94411,1388000,2248000,183480672,860000,182092672
1,1,0,-37.85012,144.99225,440000,835500,96995720,395500,96555720
4,2,291,-37.84961,145.00248,2300000,2248000,332670784,-52000,330370784
4,1,313,-37.74955,145.00949,840000,2248000,348456640,1408000,347616640
3,1,178,-37.70985,145.02073,510000,2248000,240402368,1738000,239892368
3,1,893,-37.69964,145.00945,780000,2248000,805457856,1468000,804677856
3,2,124,-37.8147,145.00852,1255000,2248000,199324304,993000,198069304
2,1,110,-37.82324,145.01331,1275000,2248000,185304592,973000,184029592
3,2,134,-37.81186,144.99472,1120000,2248000,207218464,1128000,206098464
3,2,105,-37.82146,145.00203,1190000,2248000,184305424,1058000,183115424
3,3,81,-37.82622,144.99879,1425000,2248000,166930112,823000,165505112
4,2,842,-37.81109,145.25738,1175000,2248000,768277824,1073000,767102824
3,2,306,-37.80384,145.22562,755000,2248000,343291072,1493000,342536072
4,2,502,-37.92985,145.25184,1005800,2248000,499586752,1242200,498580952
4,2,534,-38.09083,145.20139,555698,2248000,524864192,1692302,524308494
3,2,0,-37.83185,144.96817,1250000,835500,101304448,-414500,100054448
1,1,0,-37.83087,144.96864,407500,835500,96978928,428000,96571428
2,1,8888,-37.82481,144.96669,642500,2248000,7122518016,1605500,7121875516
3,1,160,-37.73915,144.80289,460000,2248000,226046352,1788000,225586352
3,1,582,-37.74538,144.79216,610000,2248000,559546560,1638000,558936560
3,1,388,-37.73163,144.80697,500000,2248000,406236128,1748000,405736128
2,1,1123,-37.86736,144.98391,615000,2248000,985864384,1633000,985249384
3,1,639,-37.56291,144.72848,455000,2248000,604532928,1793000,604077928
3,1,459,-37.78519,144.83651,810000,2248000,462371776,1438000,461561776
3,1,631,-37.78956,144.84526,805000,2248000,598309056,1443000,597504056
2,1,1501,-37.81665,145.10043,807000,2248000,1284663040,1441000,1283856040
3,2,338,-37.705,144.75759,471000,2248000,368280960,1777000,367809960
3,2,431,-37.7209,144.75053,558000,2248000,441776256,1690000,441218256
5,2,663,-37.69496,144.79511,780000,2248000,627882368,1468000,627102368
3,2,673,-37.75965,145.09937,1240000,2248000,633247808,1008000,632007808
2,1,0,-37.75267,145.00362,756000,835500,98357480,79500,97601480
4,2,651,-37.84842,145.1816,1050000,2248000,617288448,1198000,616238448
3,2,541,-37.73136,145.09562,940000,2248000,528922752,1308000,527982752
3,2,1025,-37.90188,144.65138,830000,2248000,911174016,1418000,910344016
3,2,92,-37.79683,144.99586,855000,2248000,174024848,1393000,173169848
2,1,324,-37.84469,144.95578,685000,2248000,354395648,1563000,353710648
1,1,60,-37.78469,145.03239,330000,2248000,144430656,1918000,144100656
3,2,150,-37.77639,144.91666,1010000,2248000,219811024,1238000,218801024
3,1,196,-37.77552,144.92022,990000,2248000,254573568,1258000,253583568
4,2,344,-37.75861,144.86687,773000,2248000,374462464,1475000,373689464
5,3,836,-37.78839,145.07076,3200000,2248000,766377920,-952000,763177920
4,2,1031,-38.00224,145.41081,675000,2248000,917761152,1573000,917086152
4,3,933,-37.91954,145.07637,1815000,2248000,841689600,433000,839874600
3,1,580,-37.90984,145.08001,1225000,2248000,558162496,1023000,556937496
3,2,703,-38.03062,145.35951,690000,2248000,657148736,1558000,656458736
3,1,335,-37.82876,145.13809,880000,2248000,364565504,1368000,363685504
3,1,579,-37.83831,145.13985,1264000,2248000,557400576,984000,556136576
2,1,567,-37.7877,144.84757,570000,2248000,546364992,1678000,545794992
3,2,697,-37.92829,145.00281,2655000,2248000,652175424,-407000,649520424
4,2,725,-37.92884,145.01518,2525000,2248000,675677568,-277000,673152568
3,1,684,-37.90514,145.02524,1300000,2248000,640319296,948000,639019296
3,1,406,-37.77655,144.96325,1275000,2248000,420562944,973000,419287944
3,1,186,-37.76227,144.95649,1204000,2248000,246691360,1044000,245487360
4,2,645,-37.76097,144.93933,1268000,2248000,612387264,980000,611119264
3,1,613,-37.76883,144.94592,1445000,2248000,584143232,803000,582698232
3,1,96,-37.79674,144.96563,1000000,2248000,175574160,1248000,174574160
5,5,688,-37.74281,144.72513,1150000,2248000,652382208,1098000,651232208
4,2,627,-37.89918,145.01679,1700000,2248000,598225792,548000,596525792
4,2,536,-38.03526,145.13286,732000,2248000,526396064,1516000,525664064
3,1,366,-37.96877,145.07484,800000,2248000,389042272,1448000,388242272
3,1,533,-37.96257,145.08252,877000,2248000,521026176,1371000,520149176
3,1,537,-37.96388,145.07807,900000,2248000,524184736,1348000,523284736
3,2,318,-37.91712,145.13625,780000,2248000,352732928,1468000,351952928
4,2,441,-37.73572,144.97256,1020000,2248000,451183840,1228000,450163840
2,1,476,-37.73883,144.95321,996000,2248000,474507040,1252000,473511040
2,1,151,-37.79853,144.99256,1095000,2248000,217691152,1153000,216596152
4,2,479,-37.57005,144.91909,492000,2248000,481162752,1756000,480670752
3,2,263,-37.57307,144.92513,425000,2248000,309096128,1823000,308671128
4,3,907,-37.79636,145.29351,860000,2248000,821260928,1388000,820400928
3,2,526,-37.98217,145.14061,801000,2248000,517125408,1447000,516324408
5,3,619,-37.97545,145.12054,955000,2248000,594935680,1293000,593980680
3,1,768,-37.69031,145.14557,967500,2248000,706753152,1280500,705785652
4,2,786,-37.70257,145.14995,890000,2248000,723942144,1358000,723052144
3,2,188,-37.87818,144.98532,1800000,2248000,249896624,448000,248096624
2,1,0,-37.75122,144.91805,410000,835500,98304648,425500,97894648
3,2,223,-37.74566,144.89346,930000,2248000,277484960,1318000,276554960
3,1,616,-37.71245,144.97059,650000,2248000,586522688,1598000,585872688
2,1,470,-37.79723,144.97686,700000,2248000,469786624,1548000,469086624
3,1,537,-38.14264,145.14684,570000,2248000,524248064,1678000,523678064
3,1,197,-37.70489,144.91033,512000,2248000,255349488,1736000,254837488
3,2,1036,-37.69538,145.11543,895000,2248000,920128576,1353000,919233576
5,3,789,-37.69817,145.12852,880000,2248000,729258880,1368000,728378880
4,2,1070,-37.69999,145.1279,925000,2248000,948373120,1323000,947448120
4,2,680,-37.61236,144.90753,715000,2248000,640010752,1533000,639295752
4,2,494,-37.61424,144.88705,840500,2248000,493002752,1407500,492162252
2,1,348,-37.93557,145.00463,1285000,2248000,373403552,963000,372118552
2,1,0,-37.9392,145.00095,685000,835500,98377760,150500,97692760
3,2,254,-37.94313,145.03501,957000,2248000,302094592,1291000,301137592
3,2,362,-37.82866,145.04259,2370000,2248000,387438048,-122000,385068048
2,1,264,-37.8285,145.04022,1682000,2248000,307027776,566000,305345776
3,2,666,-37.68381,144.73331,660000,2248000,627481536,1588000,626821536
3,2,103,-37.76676,145.04333,975000,2248000,182743824,1273000,181768824
4,2,713,-37.72305,144.81074,670000,2248000,666044032,1578000,665374032
3,1,364,-37.67122,145.01487,560000,2248000,387389760,1688000,386829760
2,1,416,-37.67096,145.02445,511500,2248000,427124992,1736500,426613492
4,3,552,-37.87421,145.04958,3600000,2248000,540563968,-1352000,536963968
3,2,198,-37.78667,144.88834,815000,2248000,257729152,1433000,256914152
3,1,565,-37.65702,144.92447,467000,2248000,546182528,1781000,545715528
4,2,590,-37.67815,144.58355,405000,2248000,568692096,1843000,568287096
2,1,389,-37.65623,145.07431,428000,2248000,405815872,1820000,405387872
4,2,643,-37.65959,145.08302,722500,2248000,610883264,1525500,610160764
2,1,257,-37.65636,145.03997,421000,2248000,301475296,1827000,301054296
1,1,114,-37.76911,144.92472,286000,2248000,187038688,1962000,186752688
4,2,413,-37.99906,145.09386,920000,2248000,429161056,1328000,428241056
3,1,2385,-37.79977,145.37222,620000,2248000,1984818688,1628000,1984198688
3,1,807,-37.86788,145.12121,1200000,2248000,737580736,1048000,736380736
3,1,739,-37.92769,145.16792,865000,2248000,683876160,1383000,683011160
4,1,718,-37.8888,145.07271,1920000,2248000,668582848,328000,666662848
3,1,396,-37.8363,144.87588,1230000,2248000,412613184,1018000,411383184
3,1,492,-37.83529,144.87893,1220000,2248000,488483680,1028000,487263680
3,1,550,-37.98298,145.17932,660000,2248000,534523168,1588000,533863168
2,2,1223,-37.8006,144.95419,570000,2248000,1066461440,1678000,1065891440
5,3,4221,-37.73371,145.24045,1550000,2248000,3441637376,698000,3440087376
4,2,697,-37.80864,145.17161,1075000,2248000,653631424,1173000,652556424
4,2,553,-37.71328,144.90585,1071888,2248000,539653568,1176112,538581680
2,1,132,-37.72048,144.91323,560000,2248000,202617504,1688000,202057504
5,2,546,-37.90465,145.08894,1750000,2248000,535622944,498000,533872944
3,1,700,-37.9125,145.11844,1210000,2248000,653022272,1038000,651812272
4,2,597,-37.99232,145.08469,1300000,2248000,574569600,948000,573269600
2,1,487,-37.71949,144.94283,740000,2248000,483191648,1508000,482451648
3,1,0,-37.84426,144.94415,800000,835500,99697856,35500,98897856
2,1,0,-37.85931,145.00616,1020000,835500,98371592,-184500,97351592
2,2,0,-37.85184,145.01049,660000,835500,99966640,175500,99306640
3,2,468,-37.75335,145.01642,1242000,2248000,471184768,1006000,469942768
5,3,525,-37.75017,145.01204,1350000,2248000,520554400,898000,519204400
3,3,158,-37.75026,144.98428,1020000,2248000,227765264,1228000,226745264
5,3,890,-37.70295,145.00277,912000,2248000,809002176,1336000,808090176
3,1,494,-37.71477,144.98235,685000,2248000,490113728,1563000,489428728
1,1,0,-37.71408,145.00441,270000,835500,96987224,565500,96717224
2,2,180,-37.81443,144.99079,890500,2248000,242203888,1357500,241313388
4,2,1459,-37.45709,144.68999,817000,2248000,1255501312,1431000,1254684312
3,1,446,-37.7987,145.23032,750000,2248000,452341888,1498000,451591888
4,2,725,-37.9088,145.26319,860000,2248000,675827840,1388000,674967840
4,2,448,-38.0817,145.19654,645000,2248000,456894432,1603000,456249432
4,2,463,-37.95877,145.02701,1770000,2248000,468630112,478000,466860112
3,1,297,-37.80828,144.8856,1085000,2248000,334376320,1163000,333291320
4,2,696,-37.78647,144.81319,780000,2248000,652617856,1468000,651837856
5,3,735,-37.83583,145.10664,2000000,2248000,686585472,248000,684585472
4,2,883,-37.76255,145.16233,1450000,2248000,800615744,798000,799165744
4,3,682,-37.7572,145.15456,1860000,2248000,643353600,388000,641493600
3,1,555,-37.68211,145.03204,651000,2248000,538348672,1597000,537697672
3,1,695,-37.75506,145.01841,1250000,2248000,648990720,998000,647740720
4,2,624,-37.83344,145.19063,1235000,2248000,595954176,1013000,594719176
4,2,407,-37.85028,145.18787,1290000,2248000,424459648,958000,423169648
6,2,453,-37.87309,145.23078,1180000,2248000,463574944,1068000,462394944
2,1,136,-37.85542,144.99571,957500,2248000,205845312,1290500,204887812
3,2,754,-37.85679,145.00089,2080000,2248000,697212736,168000,695132736
3,2,629,-37.73058,145.08705,852000,2248000,598463616,1396000,597611616
2,1,0,-37.80206,145.00015,505000,835500,98361152,330500,97856152
3,1,270,-37.8023,144.99615,1402500,2248000,313105600,845500,311703100
5,3,557,-37.76181,144.89327,2905000,2248000,545772224,-657000,542867224
2,1,374,-37.71811,144.87693,650000,2248000,393847200,1598000,393197200
3,2,300,-37.71917,144.87819,856000,2248000,338325440,1392000,337469440
3,1,149,-37.84587,144.94828,1505000,2248000,217455072,743000,215950072
3,2,247,-37.77976,144.81559,600000,2248000,296408192,1648000,295808192
3,1,575,-37.86715,144.80612,1005000,2248000,554037376,1243000,553032376
2,1,1097,-37.85549,145.0163,410000,2248000,965335168,1838000,964925168
3,2,257,-37.77727,144.92655,1530000,2248000,304379168,718000,302849168
3,2,254,-37.77549,144.90865,1082000,2248000,301997056,1166000,300915056
2,1,136,-37.80626,145.08776,725000,2248000,205896192,1523000,205171192
2,1,1129,-37.81623,145.0841,602000,2248000,990661888,1646000,990059888
2,2,0,-37.81192,145.07506,830000,835500,100001688,5500,99171688
3,2,975,-37.79673,145.06853,1300000,2248000,871903488,948000,870603488
5,2,629,-37.79238,145.07841,1940000,2248000,601198016,308000,599258016
3,1,697,-37.78483,145.07477,1590000,2248000,650609472,658000,649019472
4,2,765,-37.854,145.2565,705000,2248000,707429248,1543000,706724248
4,3,704,-37.99035,145.03839,2200000,2248000,660696128,48000,658496128
2,1,0,-37.9336,145.04509,420000,835500,98404272,415500,97984272
4,2,603,-37.91655,145.02448,1479000,2248000,579265472,769000,577786472
4,2,612,-37.9143,145.06582,1655000,2248000,586403328,593000,584748328
3,2,614,-37.91068,145.06802,1430000,2248000,586618624,818000,585188624
4,2,792,-38.03296,145.33439,667000,2248000,728836416,1581000,728169416
3,2,328,-37.97359,145.0214,1080000,2248000,360571904,1168000,359491904
3,4,424,-37.92988,145.01085,1750800,2248000,439615456,497200,437864656
4,1,606,-37.91684,145.01727,1605000,2248000,580038656,643000,578433656
2,1,542,-37.91704,145.01846,1035000,2248000,526727872,1213000,525692872
3,1,546,-37.67411,144.94677,505000,2248000,531182592,1743000,530677592
3,2,244,-37.82017,144.84904,663000,2248000,294062624,1585000,293399624
2,1,245,-37.77111,144.96427,860000,2248000,291958624,1388000,291098624
5,3,957,-37.77501,144.95117,2545000,2248000,861928832,-297000,859383832
3,2,401,-37.76491,144.95253,1405000,2248000,418196768,843000,416791768
2,1,69,-37.75867,144.95679,460000,2248000,152859952,1788000,152399952
4,2,425,-37.76262,144.97733,1210000,2248000,438545120,1038000,437335120
2,1,54,-37.75948,144.94758,460000,2248000,140999904,1788000,140539904
5,1,441,-37.77242,144.94458,1075000,2248000,450943808,1173000,449868808
4,2,520,-37.68155,145.04945,880000,2248000,513658368,1368000,512778368
3,2,93,-37.82921,145.00826,1837500,2248000,174826576,410500,172989076
3,2,480,-37.73321,144.75752,593000,2248000,480506624,1655000,479913624
7,4,765,-37.85103,145.11232,1642000,2248000,714625344,606000,712983344
3,2,306,-37.85473,145.1521,780000,2248000,343251744,1468000,342471744
3,2,321,-37.84627,145.08366,1290000,2248000,355063168,958000,353773168
3,2,359,-37.8279,145.07403,1930000,2248000,385086400,318000,383156400
4,2,654,-37.83208,145.07533,2408000,2248000,619592064,-160000,617184064
4,3,967,-37.81792,145.06244,4750000,2248000,868539200,-2502000,863789200
3,2,0,-37.89622,145.06032,1042000,835500,101368728,-206500,100326728
3,2,621,-37.90262,145.05709,1450000,2248000,592143040,798000,590693040
4,2,550,-38.08981,145.17353,525000,2248000,537491712,1723000,536966712
2,1,307,-37.86906,145.01986,1417500,2248000,341002848,830500,339585348
2,1,897,-37.88321,145.09594,510000,2248000,807327616,1738000,806817616
2,1,1078,-37.95745,145.07219,601000,2248000,950365888,1647000,949764888
3,1,584,-37.96911,145.07271,1145000,2248000,561326144,1103000,560181144
4,2,734,-37.76032,145.30299,911982,2248000,682947648,1336018,682035666
4,2,735,-37.92374,145.13222,1040000,2248000,683652096,1208000,682612096
3,1,192,-37.78992,144.99845,1460000,2248000,251462240,788000,250002240
3,2,677,-37.72361,144.9837,865000,2248000,636333568,1383000,635468568
2,1,144,-37.80298,144.98894,1135000,2248000,212157376,1113000,211022376
2,1,139,-37.79812,144.98873,900000,2248000,208205200,1348000,207305200
3,2,598,-37.5993,144.93867,499000,2248000,573857664,1749000,573358664
6,2,655,-37.59052,144.93066,506000,2248000,622997312,1742000,622491312
3,2,280,-37.57056,144.91751,430000,2248000,322526208,1818000,322096208
3,2,219,-37.57243,144.92663,420000,2248000,274323808,1828000,273903808
2,2,0,-37.83011,144.99044,570000,835500,99951736,265500,99381736
3,1,455,-37.79318,145.25811,637000,2248000,459471040,1611000,458834040
4,2,731,-37.78021,145.26367,905000,2248000,680554816,1343000,679649816
4,1,1717,-37.77595,145.28383,835000,2248000,1458208128,1413000,1457373128
4,2,528,-37.78774,144.76019,610000,2248000,519815232,1638000,519205232
4,2,624,-37.97533,145.12278,1255000,2248000,595929088,993000,594674088
3,2,195,-37.79979,145.15665,871000,2248000,255524944,1377000,254653944
3,2,695,-37.78541,145.15493,1451000,2248000,650671680,797000,649220680
3,2,654,-37.78496,145.14659,1385000,2248000,618264128,863000,616879128
3,2,402,-37.79408,145.16352,1360000,2248000,419120352,888000,417760352
6,4,840,-38.03548,145.11763,1850000,2248000,772556544,398000,770706544
2,1,421,-38.03093,145.11618,612500,2248000,431175296,1635500,430562796
6,3,804,-37.70872,145.16102,855000,2248000,742500800,1393000,741645800
3,1,654,-37.73209,145.13845,855000,2248000,616659648,1393000,615804648
4,3,792,-37.68966,145.14649,895000,2248000,730273600,1353000,729378600
2,1,702,-37.87944,144.99375,902000,2248000,653156096,1346000,652254096
2,1,249,-37.87964,144.9856,1410000,2248000,295145728,838000,293735728
3,2,797,-37.8867,144.99141,1360000,2248000,731193344,888000,729833344
3,2,553,-37.64463,145.04155,500000,2248000,538362880,1748000,537862880
3,2,637,-37.64097,145.05757,573000,2248000,604757376,1675000,604184376
3,2,606,-37.62858,145.03735,465000,2248000,580244224,1783000,579779224
4,2,635,-37.64051,145.05743,545000,2248000,604542848,1703000,603997848
2,1,856,-37.74022,144.89557,1980000,2248000,774785216,268000,772805216
3,2,176,-37.74936,144.89669,830000,2248000,240343344,1418000,239513344
3,2,173,-37.75382,144.89167,886000,2248000,237969872,1362000,237083872
2,1,92,-37.7388,144.89984,445000,2248000,170999456,1803000,170554456
3,3,846,-37.75228,144.88429,1050000,2248000,771429568,1198000,770379568
4,2,625,-37.71112,144.97357,800000,2248000,596596544,1448000,595796544
2,1,687,-37.71833,144.96935,786000,2248000,641267584,1462000,640481584
2,2,306,-37.87275,145.26325,617000,2248000,341956096,1631000,341339096
2,1,180,-37.7839,144.92727,990000,2248000,240567920,1258000,239577920
2,1,43,-37.78822,144.88361,455000,2248000,132270632,1793000,131815632
2,1,189,-37.83283,145.17533,680000,2248000,247839040,1568000,247159040
3,1,935,-37.69744,144.89073,755000,2248000,838577024,1493000,837822024
2,1,730,-37.85563,145.04369,762000,2248000,675312320,1486000,674550320
3,2,313,-37.85385,145.06473,1501000,2248000,348729984,747000,347228984
4,2,726,-37.89814,145.14457,1100000,2248000,676543936,1148000,675443936
3,2,328,-37.86931,145.15081,1135000,2248000,360639264,1113000,359504264
3,1,746,-37.71051,144.90925,865000,2248000,689223616,1383000,688358616
1,1,124,-37.70917,144.92291,362500,2248000,194933536,1885500,194571036
3,1,584,-37.71016,144.9215,922000,2248000,561202624,1326000,560280624
3,2,697,-37.69647,144.9113,963500,2248000,652091840,1284500,651128340
3,1,580,-37.71536,145.10205,740000,2248000,558153216,1508000,557413216
4,2,633,-37.63958,144.90267,730000,2248000,602866880,1518000,602136880
3,2,711,-37.64297,144.88796,770000,2248000,663135360,1478000,662365360
4,2,726,-37.93167,145.00134,2550000,2248000,676459712,-302000,673909712
4,2,750,-37.81557,145.04281,2800000,2248000,695438720,-552000,692638720
3,1,290,-37.81767,145.04041,1702000,2248000,328940576,546000,327238576
4,2,446,-37.82785,145.03816,3399000,2248000,455186528,-1151000,451787528
2,1,966,-37.82524,145.05568,802500,2248000,861826688,1445500,861024188
1,1,0,-37.8327,145.05428,441000,835500,97031856,394500,96590856
2,1,1324,-37.83012,145.04751,500000,2248000,1144749312,1748000,1144249312
2,1,154,-37.75343,145.06328,738000,2248000,220100288,1510000,219362288
3,1,583,-37.73752,145.05228,800000,2248000,560496064,1448000,559696064
2,1,129,-37.74931,145.05505,680000,2248000,200337280,1568000,199657280
3,1,377,-37.73712,145.0369,605000,2248000,397684992,1643000,397079992
3,1,429,-37.73704,145.03697,580000,2248000,438780576,1668000,438200576
3,2,598,-37.95357,145.02651,1600000,2248000,573953344,648000,572353344
4,2,661,-37.69655,144.75538,677000,2248000,624911296,1571000,624234296
4,2,704,-37.68175,144.74087,737500,2248000,658883456,1510500,658145956
3,2,530,-37.86713,144.71086,520000,2248000,520008576,1728000,519488576
3,1,663,-37.86658,144.71221,505000,2248000,623525696,1743000,623020696
4,2,800,-37.87051,144.7141,680000,2248000,734757824,1568000,734077824
3,1,537,-37.87016,144.70606,442500,2248000,523944800,1805500,523502300
3,2,311,-37.89829,145.08141,1203500,2248000,347164864,1044500,345961364
3,1,424,-37.76353,145.02941,1475000,2248000,434827520,773000,433352520
3,1,617,-37.77212,145.05813,1640000,2248000,587373952,608000,585733952
3,1,708,-37.68825,144.91484,590500,2248000,659193024,1657500,658602524
3,1,589,-37.7143,144.8315,895000,2248000,565099264,1353000,564204264
1,1,0,-37.79741,144.92614,400000,835500,96948848,435500,96548848
2,1,193,-37.79438,145.03369,825000,2248000,250908544,1423000,250083544
4,1,836,-37.79702,145.05352,2258000,2248000,761815680,-10000,759557680
4,2,560,-38.00512,145.14935,1250000,2248000,545369920,998000,544119920
5,2,545,-37.7323,144.77861,520000,2248000,534621344,1728000,534101344
4,2,900,-37.87695,145.2547,1218000,2248000,814121216,1030000,812903216
3,2,534,-37.67323,145.03976,600000,2248000,523349408,1648000,522749408
3,1,533,-37.67605,145.03956,487000,2248000,520966016,1761000,520479016
3,1,640,-37.6591,145.00549,572000,2248000,605505024,1676000,604933024
2,2,248,-37.72473,145.11657,650000,2248000,296011104,1598000,295361104
3,2,312,-37.86162,145.03065,1700000,2248000,347919616,548000,346219616
3,1,206,-37.87107,145.04991,1060000,2248000,262567648,1188000,261507648
2,1,81,-37.77323,144.89268,530000,2248000,162305808,1718000,161775808
2,1,0,-37.77296,144.88057,450000,835500,98284128,385500,97834128
2,1,4977,-37.77367,144.88161,353000,2248000,4031601920,1895000,4031248920
2,1,0,-37.81267,144.96273,720000,835500,98339352,115500,97619352
3,1,600,-37.68734,144.58001,295000,2248000,573634560,1953000,573339560
4,2,587,-37.69392,144.57468,347500,2248000,566317632,1900500,565970132
3,2,740,-37.68052,144.55106,410000,2248000,685851072,1838000,685441072
5,2,720,-37.98439,145.06812,1485000,2248000,673131456,763000,671646456
3,2,138,-37.84962,144.95856,1750000,2248000,210361840,498000,208611840
2,1,300,-37.80574,145.18832,695000,2248000,335567040,1553000,334872040
2,1,446,-37.81906,145.21253,655000,2248000,450967104,1593000,450312104
3,1,208,-37.8135,145.19972,775000,2248000,264233664,1473000,263458664
3,1,439,-37.82596,145.1872,820000,2248000,446786464,1428000,445966464
3,1,575,-37.72089,145.11987,900000,2248000,554213376,1348000,553313376
3,1,396,-37.71665,145.11682,806000,2248000,412747424,1442000,411941424
4,3,701,-37.71871,145.13559,980000,2248000,658353088,1268000,657373088
4,2,589,-37.90017,145.06435,1540000,2248000,568223808,708000,566683808
1,1,0,-37.89018,145.06865,470000,835500,97047448,365500,96577448
3,1,695,-37.96015,145.16618,730000,2248000,649105792,1518000,648375792
3,1,587,-37.96968,145.16832,676000,2248000,563755904,1572000,563079904
4,2,702,-37.97412,145.18022,805000,2248000,657607680,1443000,656802680
2,1,114,-37.80248,144.94846,1126000,2248000,188423440,1122000,187297440
2,1,0,-37.79999,144.94961,799000,835500,98329792,36500,97530792
3,1,170,-37.79074,144.94324,1285000,2248000,234041792,963000,232756792
3,1,326,-37.77664,144.99902,1512000,2248000,357361088,736000,355849088
3,2,239,-37.81359,145.17574,777000,2248000,290311456,1471000,289534456
4,2,344,-37.90822,145.12036,912000,2248000,374636096,1336000,373724096
4,3,719,-37.90087,145.03959,1565000,2248000,672540864,683000,670975864
2,1,772,-37.99482,145.08459,1270000,2248000,708546496,978000,707276496
4,2,641,-37.98464,145.08185,1137500,2248000,609340096,1110500,608202596
3,1,545,-37.99827,145.07497,1415000,2248000,530509312,833000,529094312
3,1,525,-37.72803,144.94624,876000,2248000,514592320,1372000,513716320
3,1,278,-37.71798,144.93965,736000,2248000,319383296,1512000,318647296
2,1,0,-37.72436,144.94855,478000,835500,98320264,357500,97842264
2,1,181,-37.83661,144.93359,1335000,2248000,241368320,913000,240033320
2,1,0,-37.85931,145.00616,740000,835500,98371592,95500,97631592
2,1,0,-37.85163,144.9943,698000,835500,98363368,137500,97665368
2,1,117,-37.84998,144.99499,780000,2248000,190828544,1468000,190048544
3,1,693,-37.74528,145.01987,920000,2248000,647409792,1328000,646489792
3,1,680,-37.74244,145.02006,1115000,2248000,637135680,1133000,636020680
3,1,483,-37.73261,144.99535,1171000,2248000,481430560,1077000,480259560
5,2,559,-37.73645,144.98715,1060000,2248000,545814400,1188000,544754400
2,1,155,-37.75308,145.01464,617500,2248000,220860592,1630500,220243092
2,2,151,-37.70426,145.01204,575000,2248000,219285344,1673000,218710344
3,2,289,-37.70798,145.02101,635000,2248000,329718720,1613000,329083720
3,1,627,-37.72216,144.99381,860000,2248000,595231424,1388000,594371424
2,2,14196,-37.81894,145.01314,615000,2248000,11319046144,1633000,11318431144
1,1,0,-37.81256,144.99347,314000,835500,96992064,521500,96678064
2,1,135,-37.82241,145.00235,1341000,2248000,205055232,907000,203714232
2,1,190,-37.80551,145.24589,609000,2248000,248669584,1639000,248060584
3,2,468,-37.74088,145.06285,1100000,2248000,471211840,1148000,470111840
2,1,0,-37.95142,145.01977,760000,835500,98390784,75500,97630784
4,2,631,-38.08814,145.12598,795000,2248000,601476416,1453000,600681416
2,1,152,-37.80697,144.8928,830000,2248000,218421072,1418000,217591072
2,1,207,-37.8071,144.88912,940000,2248000,261885232,1308000,260945232
4,2,564,-37.84405,145.0016,2920000,2248000,548421120,-672000,545501120
1,1,0,-37.83678,145.00137,400000,835500,96999768,435500,96599768
2,1,3634,-37.8281,144.96627,600000,2248000,2970289152,1648000,2969689152
5,3,1348,-37.68508,145.1395,1387000,2248000,1171041024,861000,1169654024
1,1,0,-37.86305,144.9911,480000,835500,96996528,355500,96516528
4,2,808,-37.58089,144.72183,535000,2248000,741051008,1713000,740516008
3,2,573,-37.79127,144.83713,1070000,2248000,554060224,1178000,552990224
6,2,588,-37.77049,144.83167,750000,2248000,570007552,1498000,569257552
3,1,471,-37.76951,144.83309,632000,2248000,471851424,1616000,471219424
5,2,739,-37.81708,145.09566,2505000,2248000,688144320,-257000,685639320
3,1,516,-37.82372,145.09085,1785000,2248000,507579872,463000,505794872
4,2,662,-37.75763,145.09974,1375000,2248000,625920704,873000,624545704
3,1,727,-37.67873,145.01878,740000,2248000,674271616,1508000,673531616
2,1,120,-37.75668,145.00929,745000,2248000,193197280,1503000,192452280
3,1,275,-37.76126,145.00247,1225000,2248000,317056128,1023000,315831128
3,2,289,-37.84169,144.72333,390000,2248000,329551232,1858000,329161232
3,1,676,-37.69636,144.88265,695000,2248000,633884608,1553000,633189608
3,2,291,-37.73253,145.0873,870000,2248000,331343040,1378000,330473040
4,1,541,-37.69778,145.08516,710000,2248000,528685312,1538000,527975312
3,1,660,-37.90908,144.65774,570000,2248000,621126400,1678000,620556400
3,1,126,-37.80962,144.86877,597000,2248000,199225024,1651000,198628024
2,1,0,-37.80848,144.9437,660000,835500,98327152,175500,97667152
2,1,169,-37.86682,144.90003,880000,2248000,231867632,1368000,230987632
3,1,353,-37.85432,144.88214,862000,2248000,378636352,1386000,377774352
4,2,448,-37.61337,145.03606,595000,2248000,456740576,1653000,456145576
2,1,80,-37.81133,144.89553,709500,2248000,161521744,1538500,160812244
3,1,169,-37.72752,144.88358,670000,2248000,233207344,1578000,232537344
3,1,582,-37.76063,144.8603,720000,2248000,559590272,1528000,558870272
3,3,668,-37.75962,144.86675,1107500,2248000,630746432,1140500,629638932
2,1,158,-37.845,145.25624,520000,2248000,223391008,1728000,222871008
2,1,1,-37.9332,145.03794,380000,2248000,99190104,1868000,98810104
4,5,638,-38.0683,145.33833,920000,2248000,611916672,1328000,610996672
4,4,603,-38.06788,145.33967,950000,2248000,582663744,1298000,581713744
2,1,0,-37.82945,145.15697,485000,835500,98460888,350500,97975888
3,2,548,-37.84453,145.14446,1291000,2248000,534498144,957000,533207144
3,1,720,-37.86126,145.25808,775000,2248000,668908160,1473000,668133160
4,2,719,-37.86434,145.25739,820000,2248000,671077312,1428000,670257312
3,1,694,-37.79382,144.85107,797000,2248000,648102016,1451000,647305016
2,1,304,-37.78341,144.85574,590000,2248000,338520896,1658000,337930896
2,1,0,-37.93171,145.03041,585000,835500,98395008,250500,97810008
4,1,890,-37.91053,145.02447,1580000,2248000,804487168,668000,802907168
3,1,341,-37.6886,144.92281,386000,2248000,369158304,1862000,368772304
2,1,159,-37.82073,144.8447,515000,2248000,223925184,1733000,223410184
4,2,236,-37.76549,144.96366,1515000,2248000,289170592,733000,287655592
3,1,210,-37.75746,144.95633,1037000,2248000,265657888,1211000,264620888
3,2,161,-37.77289,144.97503,1330000,2248000,228539824,918000,227209824
3,2,110,-37.76049,144.98065,937000,2248000,188236592,1311000,187299592
1,1,197,-37.77165,144.97187,290000,2248000,252662784,1958000,252372784
3,1,612,-37.70602,145.05945,730000,2248000,583415424,1518000,582685424
3,1,582,-37.70301,145.06341,660000,2248000,559708608,1588000,559048608
3,2,668,-37.85695,145.15144,1150000,2248000,629339840,1098000,628189840
4,2,592,-37.84839,145.14299,1600000,2248000,570637056,648000,569037056
2,1,92,-37.8401,145.09113,755000,2248000,171129088,1493000,170374088
2,1,0,-37.88368,145.0515,750000,835500,98402344,85500,97652344
1,1,314,-37.90321,145.0555,286000,2248000,345194720,1962000,344908720
2,1,0,-37.9003,145.06342,580010,835500,98411632,255490,97831622
4,3,326,-37.89334,145.05463,1250000,2248000,361961792,998000,360711792
3,1,0,-37.70624,144.74042,360000,835500,99556232,475500,99196232
4,2,750,-37.7277,144.73422,740000,2248000,695238528,1508000,694498528
4,2,688,-38.10984,145.17062,647000,2248000,646553536,1601000,645906536
3,2,0,-37.88289,145.09871,930000,835500,101390792,-94500,100460792
2,1,378,-37.74011,144.95267,760000,2248000,397057568,1488000,396297568
2,2,134,-37.74914,144.96826,876000,2248000,205828608,1372000,204952608
1,1,0,-37.79597,144.99108,365000,835500,96988640,470500,96623640
3,2,186,-37.79557,144.99158,1297000,2248000,248310160,951000,247013160
5,2,974,-37.79189,145.29661,865000,2248000,873985280,1383000,873120280
4,2,815,-37.78393,145.29132,760000,2248000,746957504,1488000,746197504
3,1,802,-37.81083,145.28792,725000,2248000,733725184,1523000,733000184
4,2,864,-37.80718,145.28581,1120000,2248000,785681408,1128000,784561408
4,2,830,-37.94264,145.21786,930000,2248000,758785408,1318000,757855408
3,1,539,-37.76545,144.76458,557000,2248000,525549120,1691000,524992120
3,1,697,-37.77396,144.77229,650000,2248000,650422080,1598000,649772080
3,2,539,-37.98086,145.11993,806000,2248000,527386432,1442000,526580432
4,3,674,-37.77102,145.13338,1663000,2248000,637019840,585000,635356840
4,3,706,-37.79561,145.16268,1310000,2248000,662330304,938000,661020304
3,2,798,-37.77655,145.15387,1530000,2248000,732070656,718000,730540656
2,1,196,-37.80103,145.17844,630000,2248000,253369328,1618000,252739328
3,1,615,-37.75825,145.05438,1300000,2248000,585789312,948000,584489312
5,6,900,-38.04105,145.1216,1260000,2248000,821797824,988000,820537824
3,1,197,-37.71613,145.13939,655000,2248000,255491808,1593000,254836808
1,1,1192,-37.88306,144.9841,435000,2248000,1039030848,1813000,1038595848
3,2,375,-37.62157,145.01049,490000,2248000,397667776,1758000,397177776
2,1,157,-37.64827,145.05317,417500,2248000,222452592,1830500,222035092
3,2,445,-37.75621,144.93401,1398000,2248000,452957472,850000,451559472
3,2,219,-37.8798,145.2775,664000,2248000,274575904,1584000,273911904
2,1,6367,-37.7967,144.98363,790000,2248000,5130183168,1458000,5129393168
2,2,4421,-37.79721,144.98073,830000,2248000,3593852928,1418000,3593022928
1,1,0,-37.79636,144.98394,456000,835500,96984280,379500,96528280
3,1,713,-38.16483,145.16383,565000,2248000,663353792,1683000,662788792
3,1,835,-38.15983,145.11351,810000,2248000,759738688,1438000,758928688
4,2,561,-37.68269,144.88601,749000,2248000,545960192,1499000,545211192
1,1,0,-37.8574,145.04795,260000,835500,97030856,575500,96770856
1,1,0,-37.85702,145.04801,330000,835500,97030856,505500,96700856
2,1,2015,-37.85019,145.0465,501000,2248000,1690847488,1747000,1690346488
3,2,839,-37.89813,145.14652,1070000,2248000,764482752,1178000,763412752
4,2,655,-37.69558,144.93223,700000,2248000,620278208,1548000,619578208
2,1,102,-37.71122,144.91863,400000,2248000,178910768,1848000,178510768
2,2,248,-37.69705,144.94219,675000,2248000,295900512,1573000,295225512
3,2,743,-37.71733,145.09622,866000,2248000,688561728,1382000,687695728
5,3,544,-37.61079,144.90823,800000,2248000,535489824,1448000,534689824
3,1,626,-37.71425,144.95013,735000,2248000,594413312,1513000,593678312
2,2,201,-37.71147,144.93927,595000,2248000,258756336,1653000,258161336
2,1,0,-37.94083,145.03682,771000,835500,98400032,64500,97629032
3,1,301,-38.0457,145.27395,400000,2248000,337804448,1848000,337404448
1,1,0,-37.81823,145.03972,455000,835500,97021200,380500,96566200
2,1,915,-37.81835,145.05895,615888,2248000,821522624,1632112,820906736
4,2,680,-37.94882,145.03111,1820000,2248000,640126336,428000,638306336
5,2,548,-37.90403,145.08118,1475000,2248000,537198656,773000,535723656
5,3,740,-37.76086,145.05177,2100000,2248000,690494336,148000,688394336
2,1,620,-37.76091,145.04437,1320000,2248000,588368832,928000,587048832
2,1,662,-37.68988,144.91113,575500,2248000,621470976,1672500,620895476
4,2,531,-37.71368,144.82082,635000,2248000,522214752,1613000,521579752
3,1,650,-37.71575,144.80598,620000,2248000,613291904,1628000,612671904
5,3,596,-37.7305,144.86863,1005000,2248000,576575040,1243000,575570040
3,1,590,-37.7219,144.85239,700000,2248000,565903232,1548000,565203232
1,1,0,-37.79023,144.92335,390000,835500,96946264,445500,96556264
3,1,404,-37.79893,145.04266,1410000,2248000,419033888,838000,417623888
3,2,655,-37.67414,145.0205,710500,2248000,618963712,1537500,618253212
3,1,604,-37.6708,145.01353,752000,2248000,577060608,1496000,576308608
3,1,575,-37.67146,145.03232,622000,2248000,554153600,1626000,553531600
3,2,159,-37.78502,144.86733,650000,2248000,226894368,1598000,226244368
2,2,0,-37.77813,144.87287,435000,835500,99873264,400500,99438264
4,1,697,-37.78352,144.88981,1340000,2248000,651861760,908000,650521760
3,1,702,-37.66059,144.92006,450000,2248000,654451200,1798000,654001200
3,1,570,-37.64769,144.91359,440000,2248000,550126208,1808000,549686208
4,2,1241,-37.68686,144.58157,550000,2248000,1083176576,1698000,1082626576
3,2,586,-37.67831,144.57342,373500,2248000,564158528,1874500,563785028
2,1,128,-37.98346,145.06313,640000,2248000,199579456,1608000,198939456
3,1,331,-37.97759,145.06482,940000,2248000,361376672,1308000,360436672
3,2,840,-37.67391,145.0618,705000,2248000,765194432,1543000,764489432
4,2,530,-37.65217,145.04863,790000,2248000,521557376,1458000,520767376
5,3,656,-37.6641,145.05123,704500,2248000,624097600,1543500,623393100
4,2,531,-37.65121,145.05404,550000,2248000,522350912,1698000,521800912
5,3,531,-37.65116,145.05439,598000,2248000,525310560,1650000,524712560
3,1,622,-37.66294,145.06301,592000,2248000,591315520,1656000,590723520
3,1,546,-37.65359,145.04276,602000,2248000,531239264,1646000,530637264
4,2,846,-37.81018,145.35396,735000,2248000,771498304,1513000,770763304
4,1,478,-37.76421,144.90571,1270000,2248000,478793824,978000,477523824
3,2,1103,-37.78695,145.32513,650000,2248000,973218368,1598000,972568368
4,2,530,-38.00429,145.10286,1400000,2248000,521632192,848000,520232192
3,2,304,-38.00644,145.08478,1627000,2248000,341647552,621000,340020552
3,1,717,-37.87754,145.12076,1850000,2248000,666454592,398000,664604592
4,2,632,-37.89465,145.06984,1820000,2248000,602209408,428000,600389408
2,2,0,-37.80202,144.95104,785000,835500,99924184,50500,99139184
2,1,149,-37.8231,145.17911,676000,2248000,216228272,1572000,215552272
3,1,598,-37.80827,145.17885,1002000,2248000,572436736,1246000,571434736
4,3,289,-37.82895,145.17678,1175000,2248000,332788352,1073000,331613352
3,2,295,-37.90088,145.11692,875000,2248000,334542240,1373000,333667240
4,2,0,-37.91121,145.09598,774000,835500,102758648,61500,101984648
1,1,0,-37.89976,145.04215,327000,835500,97032264,508500,96705264
4,2,700,-37.9075,145.05329,1900000,2248000,655940992,348000,654040992
4,2,220,-38.00205,145.07853,2185000,2248000,276624288,63000,274439288
3,2,330,-37.72623,144.94521,1210000,2248000,362076544,1038000,360866544
1,1,168,-37.69828,145.02184,351000,2248000,229766272,1897000,229415272
4,2,1016,-37.78372,145.25311,1725000,2248000,905784000,523000,904059000
2,1,123,-37.82223,145.22504,633000,2248000,195708672,1615000,195075672
4,1,894,-37.8159,145.24688,1090000,2248000,807774144,1158000,806684144
4,2,675,-37.91692,145.25896,936000,2248000,636311296,1312000,635375296
3,2,537,-37.92778,145.24796,860000,2248000,525878336,1388000,525018336
4,3,709,-37.95095,145.02096,850000,2248000,664632256,1398000,663782256
4,2,1151,-38.11336,145.15035,800000,2248000,1012449728,1448000,1011649728
3,2,81,-37.83631,144.95536,1720000,2248000,165311280,528000,163591280
3,2,545,-37.64426,145.1,690000,2248000,532076384,1558000,531386384
4,2,613,-37.62648,145.07141,875000,2248000,587163200,1373000,586288200
3,2,155,-37.63478,145.08486,420000,2248000,223849392,1828000,223429392
4,2,609,-37.63454,145.06894,677500,2248000,584001408,1570500,583323908
2,1,876,-37.83766,144.98799,600000,2248000,790659584,1648000,790059584
2,1,17200,-37.83613,144.99661,762500,2248000,13691502592,1485500,13690740092
4,2,176,-37.83986,144.98598,1855500,2248000,241775152,392500,239919652
2,1,174,-37.83162,144.88742,802000,2248000,235807216,1446000,235005216
4,1,559,-37.73593,144.8101,631000,2248000,542745856,1617000,542114856
3,1,674,-37.73704,144.79108,582000,2248000,632252480,1666000,631670480
1,1,0,-37.87094,144.9807,468000,835500,96991056,367500,96523056
1,1,548,-37.87312,144.97986,470000,2248000,530074560,1778000,529604560
3,2,288,-37.73415,144.91852,750000,2248000,328868480,1498000,328118480
4,2,587,-37.58231,144.69962,410000,2248000,566381440,1838000,565971440
4,2,581,-37.57355,144.70854,512500,2248000,561644096,1735500,561131596
3,1,508,-37.7807,144.83648,830500,2248000,501095904,1417500,500265404
3,1,613,-37.80046,144.82676,551000,2248000,584073600,1697000,583522600
3,1,283,-37.79703,144.81228,450000,2248000,323265696,1798000,322815696
4,3,896,-37.76797,145.13799,1635000,2248000,812468736,613000,810833736
3,2,706,-37.77185,145.12509,1138000,2248000,659344896,1110000,658206896
3,1,518,-37.85971,145.31036,477000,2248000,509299744,1771000,508822744
3,1,533,-37.68579,144.98878,605000,2248000,520935968,1643000,520330968
3,1,544,-37.68336,145.0029,610000,2248000,529637600,1638000,529027600
3,1,538,-37.67751,144.98663,580000,2248000,524885120,1668000,524305120
1,1,0,-37.75443,145.00919,415000,835500,96994904,420500,96579904
2,1,225,-37.75642,144.98755,905000,2248000,276165248,1343000,275260248
3,2,347,-37.83963,144.71487,451000,2248000,375383136,1797000,374932136
4,2,700,-37.70598,144.87616,895000,2248000,655808384,1353000,654913384
4,1,0,-37.70695,144.88514,586000,835500,101011608,249500,100425608
4,2,652,-37.87325,145.23244,1055000,2248000,618112960,1193000,617057960
3,2,847,-37.88421,144.67869,529000,2248000,770515456,1719000,769986456
3,1,531,-37.88996,144.65526,484000,2248000,519174048,1764000,518690048
2,1,17,-37.8118,144.95259,670000,2248000,111768096,1578000,111098096
2,1,75,-37.80473,144.9435,510000,2248000,157598992,1738000,157088992
3,1,542,-37.66948,144.90385,410000,2248000,527994432,1838000,527584432
1,1,0,-37.85687,144.99748,410000,835500,96999744,425500,96589744
4,2,400,-37.87047,144.59864,478000,2248000,418567264,1770000,418089264
3,1,284,-37.81335,144.89471,1285000,2248000,324108672,963000,322823672
3,1,142,-37.80359,144.99538,1635000,2248000,211947008,613000,210312008
3,1,697,-37.87256,144.8078,1225000,2248000,650455552,1023000,649230552
3,2,305,-37.871,144.81153,767000,2248000,342253760,1481000,341486760
4,2,749,-37.88413,144.79033,810000,2248000,694501184,1438000,693691184
2,2,3093,-37.86165,145.02148,821000,2248000,2544368896,1427000,2543547896
4,3,267,-37.87036,145.08471,1520000,2248000,315349920,728000,313829920
3,2,634,-37.86516,145.07958,2299500,2248000,602426368,-51500,600126868
4,3,848,-37.81462,145.08776,2360000,2248000,774508864,-112000,772148864
4,2,433,-37.78368,145.09545,1460000,2248000,444942656,788000,443482656
4,3,306,-37.92893,145.04581,1280000,2248000,346154528,968000,344874528
4,3,429,-37.91582,145.048,1750000,2248000,443361120,498000,441611120
3,1,492,-37.81169,145.15735,1100000,2248000,488652256,1148000,487552256
4,2,580,-37.8051,145.14351,1250000,2248000,561148736,998000,559898736
3,1,905,-37.7063,145.12215,830000,2248000,815011584,1418000,814181584
4,4,508,-37.90904,144.99868,4050000,2248000,507356832,-1802000,503306832
4,2,396,-37.88779,144.99933,2210000,2248000,415654752,38000,413444752
3,1,605,-37.93063,145.01314,1680000,2248000,577881216,568000,576201216
2,1,275,-37.91106,145.02394,890000,2248000,315720768,1358000,314830768
3,1,697,-37.68557,144.93156,632000,2248000,650509760,1616000,649877760
3,1,302,-37.76085,144.95834,1310000,2248000,338367008,938000,337057008
4,2,444,-37.7628,144.94011,1500000,2248000,453537952,748000,452037952
4,3,646,-37.77387,145.0889,1751000,2248000,614864448,497000,613113448
4,2,287,-37.69382,145.04831,685000,2248000,329519520,1563000,328834520
4,1,542,-37.68238,145.06432,725000,2248000,529460960,1523000,528735960
2,1,90,-37.70912,145.05181,505000,2248000,169508912,1743000,169003912
4,2,760,-37.67935,145.05728,1253000,2248000,703334592,995000,702081592
4,2,627,-37.85374,145.12459,1390000,2248000,598286848,858000,596896848
4,2,650,-37.83057,145.08482,2725000,2248000,616436544,-477000,613711544
4,2,463,-37.73531,144.74335,870000,2248000,468429248,1378000,467559248
3,2,779,-38.11471,145.18248,552500,2248000,717112384,1695500,716559884
4,2,494,-37.87206,145.03512,1925000,2248000,493124224,323000,491199224
4,2,402,-37.88658,145.09297,995000,2248000,420453984,1253000,419458984
4,2,679,-37.96098,145.04275,1200000,2248000,639344640,1048000,638144640
4,2,625,-37.92801,145.1057,1241000,2248000,596703360,1007000,595462360
4,1,711,-37.9255,145.11331,1250000,2248000,663080192,998000,661830192
3,1,270,-37.92624,145.1321,729500,2248000,313203808,1518500,312474308
2,1,0,-37.79627,144.99229,560000,835500,98355632,275500,97795632
4,2,482,-37.57416,144.91269,565000,2248000,483530240,1683000,482965240
4,2,756,-37.5729,144.93663,615000,2248000,700086720,1633000,699471720
4,2,400,-37.5951,144.9091,548000,2248000,418725984,1700000,418177984
3,2,1005,-37.60574,144.92548,716000,2248000,895501824,1532000,894785824
3,2,269,-37.78499,145.2647,730000,2248000,314071808,1518000,313341808
3,2,507,-37.76572,145.28915,766000,2248000,502175744,1482000,501409744
4,2,254,-37.81007,145.06792,1680000,2248000,303465376,568000,301785376
3,2,358,-37.7145,144.77132,475000,2248000,384096448,1773000,383621448
3,2,790,-37.66529,145.15363,815000,2248000,725735040,1433000,724920040
6,3,850,-37.62856,144.71825,615000,2248000,778572608,1633000,777957608
5,3,785,-37.78148,145.17818,1328000,2248000,726137984,920000,724809984
2,2,997,-37.8161,144.98494,1300000,2248000,887874560,948000,886574560
4,2,573,-37.70477,145.16552,762000,2248000,555618432,1486000,554856432
3,2,812,-37.70577,145.1316,900000,2248000,743112832,1348000,742212832
4,2,558,-37.88014,144.99347,3175000,2248000,543678656,-927000,540503656
2,1,3256,-37.87594,144.98833,520000,2248000,2671575296,1728000,2671055296
4,2,951,-37.74997,144.90752,2165000,2248000,854197888,83000,852032888
5,3,663,-37.74351,144.92174,2050000,2248000,629559296,198000,627509296
4,2,465,-37.75178,144.89876,1500000,2248000,470107456,748000,468607456
1,1,1730,-37.79636,144.98394,545000,2248000,1464201216,1703000,1463656216
3,1,139,-37.79068,144.97824,1705000,2248000,209564048,543000,207859048
3,1,293,-37.78446,144.92797,1220000,2248000,331238400,1028000,330018400
2,1,0,-37.79975,144.88368,455000,835500,98289200,380500,97834200
2,2,88,-37.78872,144.88891,575000,2248000,169430688,1673000,168855688
3,2,1290,-37.48381,144.60052,775000,2248000,1120522752,1473000,1119747752
3,1,552,-37.68641,144.89826,629000,2248000,535896000,1619000,535267000
5,3,720,-37.85875,145.07978,3400000,2248000,674717120,-1152000,671317120
1,1,0,-37.85852,145.04547,320000,835500,97029472,515500,96709472
4,3,409,-37.852,145.07321,2165000,2248000,427563168,83000,425398168
2,1,100,-37.85258,145.08589,851000,2248000,177449728,1397000,176598728
3,2,853,-37.88984,145.18016,1311000,2248000,775566592,937000,774255592
2,1,193,-37.70612,144.9144,565000,2248000,250824752,1683000,250259752
3,1,604,-37.70855,144.90441,770000,2248000,576997888,1478000,576227888
3,1,594,-37.69039,145.09753,714000,2248000,569211584,1534000,568497584
3,2,609,-37.71636,145.09792,815000,2248000,582662592,1433000,581847592
3,1,587,-37.94087,145.03366,1345000,2248000,563669632,903000,562324632
1,1,0,-37.82334,145.04015,420000,835500,97022056,415500,96602056
2,1,230,-37.81813,145.02295,1857000,2248000,280145760,391000,278288760
3,1,333,-37.82737,145.02971,1425000,2248000,362918016,823000,361493016
3,2,242,-37.82834,145.03937,1910000,2248000,292600192,338000,290690192
3,2,0,-37.82452,145.02204,1485000,835500,101336752,-649500,99851752
1,1,0,-37.82742,145.05324,505000,835500,97030592,330500,96525592
3,2,471,-37.82996,145.24311,912000,2248000,473704160,1336000,472792160
2,1,2020,-37.75692,145.06426,450000,2248000,1694799104,1798000,1694349104
4,2,596,-37.75008,145.05051,1645000,2248000,573729728,603000,572084728
4,2,600,-37.6844,144.75595,580000,2248000,576702016,1668000,576122016
4,2,455,-37.9016,145.08294,1570000,2248000,462335456,678000,460765456
5,2,1034,-37.63826,145.1991,790000,2248000,921325184,1458000,920535184
3,1,704,-37.6845,144.90761,550000,2248000,656026944,1698000,655476944
3,2,223,-37.79496,144.92659,1225000,2248000,277511136,1023000,276286136
3,1,446,-37.79855,145.04493,1510000,2248000,452227744,738000,450717744
3,2,0,-37.80495,145.04949,1007000,835500,101351328,-171500,100344328
2,2,0,-37.80593,145.05121,860000,835500,99986304,-24500,99126304
3,1,118,-37.80857,144.87682,570000,2248000,192907440,1678000,192337440
3,1,275,-37.81167,144.88346,900000,2248000,316988800,1348000,316088800
4,1,651,-37.67028,144.59455,345000,2248000,615312896,1903000,614967896
2,2,126,-37.78458,144.88106,642500,2248000,199456704,1605500,198814204
3,2,159,-37.78974,144.88143,798000,2248000,226903600,1450000,226105600
3,2,186,-37.78559,144.86483,710000,2248000,248230976,1538000,247520976
4,3,787,-37.86044,145.0335,4050000,2248000,726272640,-1802000,722222640
3,1,354,-37.85189,145.03335,1650000,2248000,379519392,598000,377869392
3,2,400,-37.85183,145.03863,2020000,2248000,417469664,228000,415449664
3,3,1011,-37.8652,145.05248,2500000,2248000,901945600,-252000,899445600
3,1,1128,-37.87923,145.08955,2500000,2248000,991248512,-252000,988748512
3,2,352,-37.77413,144.87533,1200000,2248000,379425696,1048000,378225696
3,2,366,-37.7816,144.88999,940000,2248000,390499776,1308000,389559776
2,1,397,-37.90978,145.02937,1200000,2248000,412140384,1048000,410940384
4,2,935,-37.68503,144.54237,600000,2248000,841320768,1648000,840720768
4,2,408,-37.98707,145.0609,2025000,2248000,425187840,223000,423162840
4,2,475,-37.606,145.08785,630000,2248000,478109696,1618000,477479696
3,2,674,-37.76389,144.9185,1225000,2248000,633927232,1023000,632702232
4,2,656,-38.00119,145.08589,1800000,2248000,621198976,448000,619398976
3,2,344,-37.85991,145.14523,900000,2248000,373279520,1348000,372379520
5,5,667,-37.88007,145.12328,2558000,2248000,636047104,-310000,633489104
3,2,200,-37.85134,144.88636,730000,2248000,259316128,1518000,258586128
3,2,324,-37.7431,144.88722,1230000,2248000,357300960,1018000,356070960
2,1,0,-37.91061,145.0862,601000,835500,98426864,234500,97825864
1,1,2029,-37.90143,145.04184,370000,2248000,1700548608,1878000,1700178608
3,2,0,-37.72882,144.93301,900000,835500,101270704,-64500,100370704
1,1,0,-37.7237,144.92232,257500,835500,96937824,578000,96680324
1,1,995,-37.7237,144.92232,257500,2248000,883285120,1990500,883027620
3,2,256,-37.72034,144.93788,1114000,2248000,303589184,1134000,302475184
3,2,312,-37.89273,144.72559,520000,2248000,347735520,1728000,347215520
2,2,0,-37.84158,144.93809,760000,835500,99920872,75500,99160872
4,2,401,-37.85565,145.00839,2635000,2248000,419608000,-387000,416973000
2,1,192,-37.85562,145.00571,1250000,2248000,250108224,998000,248858224
1,1,0,-37.85126,145.00832,400000,835500,97005744,435500,96605744
4,2,787,-37.85768,145.00254,4200000,2248000,724659904,-1952000,720459904
2,1,0,-37.85059,144.99188,626000,835500,98361760,209500,97735760
4,1,552,-37.72879,144.98538,1148000,2248000,537320768,1100000,536172768
3,1,529,-37.72017,144.99873,935000,2248000,517784960,1313000,516849960
3,2,292,-37.71331,144.9871,510000,2248000,332069440,1738000,331559440
4,2,479,-37.70952,145.033,755000,2248000,481249312,1493000,480494312
4,2,499,-37.72614,144.99892,1200000,2248000,497036288,1048000,495836288
3,2,461,-37.82536,145.22228,800000,2248000,465787808,1448000,464987808
5,3,694,-37.73968,145.07973,1170000,2248000,654155264,1078000,652985264
3,2,590,-37.89628,145.22294,870000,2248000,567745088,1378000,566875088
4,3,153,-37.83591,144.94963,1800000,2248000,225168688,448000,223368688
4,2,196,-37.63873,145.07805,485000,2248000,257614144,1763000,257129144
2,2,0,-37.82863,144.98514,1350000,835500,99948304,-514500,98598304
1,1,0,-37.8446,145.00018,410000,835500,96999960,425500,96589960
2,1,0,-37.86257,144.99161,701000,835500,98363016,134500,97662016
4,2,613,-37.86667,144.98324,1600000,2248000,587137216,648000,585537216
7,3,608,-37.73681,144.90587,2000000,2248000,588814720,248000,586814720
4,3,861,-37.73154,144.92243,1610000,2248000,784671296,638000,783061296
3,2,485,-37.78703,144.84569,700000,2248000,484518720,1548000,483818720
2,1,418,-37.79595,144.83206,615000,2248000,428601888,1633000,427986888
5,3,593,-37.83199,145.10877,2400000,2248000,574363904,-152000,571963904
4,2,498,-37.84267,144.65407,505000,2248000,496047360,1743000,495542360
4,2,452,-37.83851,144.6887,560000,2248000,459714464,1688000,459154464
4,2,646,-37.75807,145.13478,1205000,2248000,613297472,1043000,612092472
5,3,787,-37.76873,145.15894,1750000,2248000,727705280,498000,725955280
5,2,648,-37.77033,145.1214,1410000,2248000,616237504,838000,614827504
3,2,541,-37.67231,145.00556,670000,2248000,528860352,1578000,528190352
3,2,0,-37.8404,145.01425,1860000,835500,101333816,-1024500,99473816
3,2,187,-37.84297,145.01819,1350000,2248000,249122416,898000,247772416
4,2,539,-37.83459,145.21264,980000,2248000,528792480,1268000,527812480
4,1,534,-37.88496,144.66332,455000,2248000,522915520,1793000,522460520
3,1,610,-37.88632,144.67582,455000,2248000,581619904,1793000,581164904
4,2,323,-37.79429,144.87412,1276000,2248000,357874848,972000,356598848
4,2,752,-37.91212,145.1793,1157000,2248000,697114688,1091000,695957688
5,2,672,-37.91299,145.1767,1100000,2248000,635255488,1148000,634155488
4,2,512,-37.87959,144.60977,500000,2248000,507088608,1748000,506588608
4,3,234,-37.81961,144.88132,1142000,2248000,289138944,1106000,287996944
2,1,178,-37.81481,144.88013,780000,2248000,238961952,1468000,238181952
4,2,629,-37.86027,144.82073,935000,2248000,599681152,1313000,598746152
3,2,159,-37.86472,144.82929,815000,2248000,226880336,1433000,226065336
3,1,180,-37.83648,144.86296,451500,2248000,241900752,1796500,241449252
3,2,2905,-37.78258,144.91694,825000,2248000,2397084928,1423000,2396259928
2,1,1727,-37.77341,144.9013,425500,2248000,1463143040,1822500,1462717540
3,1,199,-37.77561,144.91695,1306000,2248000,256942480,942000,255636480
3,1,726,-37.86173,145.11074,1420000,2248000,673559296,828000,672139296
3,2,0,-38.02768,145.10187,805000,835500,101409744,30500,100604744
4,2,581,-37.76421,144.85594,934000,2248000,561757184,1314000,560823184
3,2,656,-37.8079,145.09162,2330000,2248000,619813632,-82000,617483632
3,2,792,-37.82809,145.29287,762000,2248000,727420544,1486000,726658544
3,1,448,-37.82956,145.13868,1070000,2248000,453869696,1178000,452799696
2,1,305,-37.80906,145.15787,706000,2248000,339500192,1542000,338794192
3,2,723,-37.85284,145.26942,785000,2248000,672878400,1463000,672093400
4,2,2033,-37.86669,145.29959,950000,2248000,1709556224,1298000,1708606224
4,3,498,-37.90396,144.99126,2800000,2248000,497855328,-552000,495055328
1,1,0,-37.9041,144.9993,290000,835500,97006400,545500,96716400
3,1,640,-37.68187,144.92421,570500,2248000,605457664,1677500,604887164
4,2,696,-37.68584,144.9315,631000,2248000,652678912,1617000,652047912
2,1,0,-37.82212,144.84477,372100,835500,98267872,463400,97895772
4,2,372,-37.76166,144.95065,1350000,2248000,396642784,898000,395292784
2,2,65,-37.76812,144.97414,702500,2248000,151303856,1545500,150601356
1,1,1388,-37.7684,144.94214,275000,2248000,1193890048,1973000,1193615048
2,1,207,-37.76221,144.94055,835000,2248000,261911648,1413000,261076648
3,1,540,-37.70636,145.05462,710000,2248000,526510944,1538000,525800944
3,2,483,-37.89204,145.06086,1840000,2248000,483082880,408000,481242880
2,1,2048,-37.88642,145.05979,430000,2248000,1716939904,1818000,1716509904
2,1,198,-38.0796,145.13272,495000,2248000,254954496,1753000,254459496
2,2,339,-38.09665,145.17646,403500,2248000,368008864,1844500,367605364
1,1,60,-37.87972,145.03351,361000,2248000,144442528,1887000,144081528
3,2,382,-37.88304,145.0969,960000,2248000,403283776,1288000,402323776
3,1,227,-37.75296,144.95967,900000,2248000,279094496,1348000,278194496
1,1,0,-37.79597,144.99108,365000,835500,96988640,470500,96623640
2,1,38,-37.57467,144.92229,310000,2248000,128317856,1938000,128007856
3,1,396,-37.79486,145.28674,662000,2248000,412861248,1586000,412199248
3,2,543,-37.7143,144.77096,560000,2248000,530301504,1688000,529741504
3,2,251,-37.98146,145.11715,802000,2248000,299778720,1446000,298976720
3,2,801,-37.98596,145.13187,800000,2248000,734452672,1448000,733652672
4,2,676,-37.97936,145.13302,854000,2248000,637031488,1394000,636177488
3,2,239,-37.77323,145.18029,920000,2248000,290309536,1328000,289389536
3,1,720,-37.80349,145.19666,904000,2248000,668863616,1344000,667959616
3,1,598,-37.76093,145.056,1440000,2248000,572355520,808000,570915520
4,3,791,-37.71296,145.13773,1054000,2248000,729480576,1194000,728426576
4,2,669,-37.96466,145.27006,625000,2248000,631581952,1623000,630956952
3,1,524,-37.64273,145.03751,600000,2248000,513848160,1648000,513248160
3,2,388,-37.62864,145.02265,630000,2248000,407950016,1618000,407320016
4,3,631,-37.6246,145.01686,1012000,2248000,602948096,1236000,601936096
4,2,548,-37.64386,145.04817,565000,2248000,535781504,1683000,535216504
2,1,0,-37.7494,144.92096,502500,835500,98306216,333000,97803716
3,2,585,-37.75374,144.88932,1410000,2248000,563571520,838000,562161520
4,2,1014,-37.88189,145.29148,748888,2248000,904238464,1499112,903489576
4,2,738,-37.89863,145.26708,850000,2248000,686102976,1398000,685252976
1,1,0,-37.80348,144.98257,490000,835500,96984280,345500,96494280
2,1,0,-37.79711,144.88825,395000,835500,98291696,440500,97896696
2,1,318,-37.79529,144.88453,991000,2248000,349604224,1257000,348613224
4,2,294,-37.85156,145.16923,945000,2248000,335144544,1303000,334199544
2,1,581,-37.84207,145.17795,1020000,2248000,557638912,1228000,556618912
3,1,578,-38.13743,145.16702,506000,2248000,556662144,1742000,556156144
4,1,622,-38.16146,145.12997,755000,2248000,592781568,1493000,592026568
3,1,412,-37.49175,144.59565,426000,2248000,425044960,1822000,424618960
2,1,0,-37.85145,145.09107,540000,835500,98422912,295500,97882912
2,1,229,-37.87606,145.15951,960000,2248000,279446336,1288000,278486336
5,2,701,-37.88902,145.16678,1116500,2248000,658165248,1131500,657048748
2,1,240,-37.71254,145.09705,585000,2248000,288081984,1663000,287496984
4,2,626,-37.70859,145.10464,800000,2248000,597467264,1448000,596667264
3,2,653,-37.71846,145.09689,896000,2248000,617435456,1352000,616539456
3,2,5259,-37.81442,145.01531,1150000,2248000,4257512704,1098000,4256362704
3,2,109,-37.81442,145.01531,1100000,2248000,187473952,1148000,186373952
2,1,0,-37.82118,145.24138,525000,835500,98511880,310500,97986880
2,1,140,-37.74835,145.05042,650000,2248000,209027600,1598000,208377600
2,1,498,-37.73759,145.04236,580000,2248000,491948384,1668000,491368384
3,2,578,-37.87326,144.69103,536500,2248000,557931456,1711500,557394956
4,2,815,-37.71757,144.81328,705000,2248000,746655360,1543000,745950360
4,2,757,-37.72483,144.8143,590000,2248000,700819456,1658000,700229456
3,2,313,-37.74214,144.86965,920000,2248000,348596800,1328000,347676800
4,4,500,-37.73573,144.87531,1100000,2248000,500938112,1148000,499838112
3,1,575,-37.74316,144.87894,840000,2248000,554067712,1408000,553227712
2,2,0,-37.79013,144.92359,535000,835500,99905896,300500,99370896
3,2,151,-37.80509,145.05572,1080000,2248000,220690304,1168000,219610304
4,1,384,-37.99318,145.15939,575000,2248000,404688736,1673000,404113736
3,1,545,-37.78571,144.87346,930000,2248000,530360288,1318000,529430288
2,2,279,-37.78799,144.87515,650000,2248000,320369184,1598000,319719184
3,2,189,-37.78606,144.87205,702000,2248000,250606384,1546000,249904384
2,1,0,-37.77117,144.88041,440000,835500,98283832,395500,97843832
3,1,631,-37.66004,144.92338,520000,2248000,598342016,1728000,597822016
3,1,798,-37.65384,144.92272,520000,2248000,730320704,1728000,729800704
4,3,653,-37.65155,144.91912,515000,2248000,620277568,1733000,619762568
2,1,0,-37.81301,144.96924,387000,835500,98343408,448500,97956408
3,1,580,-37.70153,144.57243,336000,2248000,557825600,1912000,557489600
4,2,655,-37.69548,144.56775,426000,2248000,620053952,1822000,619627952
3,1,840,-37.66919,145.06799,775500,2248000,763604480,1472500,762828980
3,2,615,-37.67519,145.06201,726000,2248000,587377536,1522000,586651536
4,1,666,-37.67626,145.0659,710000,2248000,627458240,1538000,626748240
3,2,260,-37.72394,145.12456,820000,2248000,306865696,1428000,306045696
4,2,388,-37.7685,144.91103,1425000,2248000,409263968,823000,407838968
3,2,280,-37.94111,145.0431,935000,2248000,322647072,1313000,321712072
5,5,729,-37.86582,145.14824,2248000,2248000,685059392,0,682811392
3,1,743,-37.8958,145.11969,1260000,2248000,687003904,988000,685743904
5,2,731,-37.9298,145.16524,960000,2248000,681878080,1288000,680918080
3,2,137,-37.887,145.07303,956000,2248000,209646384,1292000,208690384
3,2,688,-38.037,145.30862,605000,2248000,645263680,1643000,644658680
4,1,558,-37.73834,144.88197,950000,2248000,542000064,1298000,541050064
2,1,0,-37.8044,144.95657,541000,835500,98334608,294500,97793608
3,2,258,-37.76788,144.98621,1307500,2248000,305205120,940500,303897620
4,3,727,-37.90779,145.15042,1211000,2248000,678932224,1037000,677721224
4,2,592,-37.90821,145.09314,1610000,2248000,570613440,638000,569003440
2,1,622,-37.90168,145.11081,1150000,2248000,590006784,1098000,588856784
4,2,553,-38.08699,145.48273,435000,2248000,540052608,1813000,539617608
3,2,0,-37.99577,145.07215,1190000,835500,101387712,-354500,100197712
1,1,80,-37.99825,145.08696,503750,2248000,160295328,1744250,159791578
4,2,540,-37.90715,144.76527,690000,2248000,529315968,1558000,528625968
4,2,416,-37.89279,144.73158,596000,2248000,431296480,1652000,430700480
4,2,448,-37.8914,144.72014,698000,2248000,456578816,1550000,455880816
2,1,0,-37.85924,145.00563,500000,835500,98371240,335500,97871240
3,1,743,-37.70964,145.0171,953000,2248000,686918912,1295000,685965912
2,1,0,-37.72919,145.00533,468000,835500,98355768,367500,97887768
2,2,126,-37.72357,144.98562,710000,2248000,199513888,1538000,198803888
2,1,230,-37.709,145.02014,502000,2248000,280131232,1746000,279629232
2,2,0,-37.82201,145.0104,800000,835500,99963080,35500,99163080
3,1,314,-37.81953,145.24907,710000,2248000,348036416,1538000,347326416
3,2,721,-37.91713,145.24706,735000,2248000,671291520,1513000,670556520
3,2,551,-37.94266,145.24662,755000,2248000,536943424,1493000,536188424
3,2,640,-37.63799,144.92924,537000,2248000,607048960,1711000,606511960
2,1,150,-38.12477,145.13668,386000,2248000,217027920,1862000,216641920
4,2,611,-38.10226,145.14459,763000,2248000,585683648,1485000,584920648
4,2,542,-38.11161,145.15011,768000,2248000,531157504,1480000,530389504
3,2,216,-37.83863,144.96208,2800000,2248000,272006016,-552000,269206016
2,1,305,-37.6522,145.09261,345000,2248000,339441568,1903000,339096568
2,1,0,-37.83613,144.99661,666000,835500,98362984,169500,97696984
2,1,419,-37.7398,144.80348,610000,2248000,429367968,1638000,428757968
3,1,606,-37.73789,144.78734,550000,2248000,578509952,1698000,577959952
4,2,699,-37.73986,144.81105,520000,2248000,654981952,1728000,654461952
2,1,0,-37.87349,144.9798,470000,835500,98357024,365500,97887024
3,1,446,-37.79354,144.8328,860000,2248000,452096608,1388000,451236608
4,3,724,-37.70941,144.7873,853000,2248000,676314496,1395000,675461496
2,2,586,-37.84266,145.02355,1140000,2248000,563088576,1108000,561948576
2,1,16000,-37.78466,144.93829,341500,2248000,12743102464,1906500,12742760964
3,1,722,-37.8324,145.20467,1111500,2248000,670452544,1136500,669341044
4,3,728,-37.88009,145.22736,1045000,2248000,679766656,1203000,678721656
3,1,137,-37.87615,145.23192,622000,2248000,208149632,1626000,207527632
3,2,830,-37.75079,145.20617,826000,2248000,757389376,1422000,756563376
2,1,298,-37.71098,145.08926,655000,2248000,333914336,1593000,333259336
3,2,557,-37.87975,144.66459,505000,2248000,541319680,1743000,540814680
2,1,190,-37.90423,144.67008,335000,2248000,248326752,1913000,247991752
3,2,125,-37.80735,144.87361,700000,2248000,200030688,1548000,199330688
3,2,898,-37.67823,144.90002,800000,2248000,810932800,1448000,810132800
5,2,698,-37.8921,145.19118,1090000,2248000,655809792,1158000,654719792
4,2,388,-37.86159,144.89926,1920000,2248000,409267648,328000,407347648
4,2,448,-37.61944,145.01243,530000,2248000,456726784,1718000,456196784
3,2,444,-37.81662,144.866,982500,2248000,452132416,1265500,451149916
3,1,433,-37.81183,144.88569,1230000,2248000,441857472,1018000,440627472
2,2,147,-37.80269,145.0001,1190000,2248000,216128384,1058000,214938384
3,2,673,-37.76316,144.89799,1680000,2248000,633124224,568000,631444224
3,1,466,-37.87019,144.7843,620000,2248000,467881696,1628000,467261696
3,2,529,-37.84107,144.84179,830000,2248000,519295776,1418000,518465776
4,2,562,-37.84384,144.84637,805000,2248000,546745024,1443000,545940024
2,1,170,-37.83658,144.86199,510000,2248000,232630928,1738000,232120928
2,1,0,-37.85549,145.0163,486000,835500,98377368,349500,97891368
3,1,159,-37.78329,144.91842,855000,2248000,225332352,1393000,224477352
2,1,319,-37.77266,144.9131,1035000,2248000,350409440,1213000,349374440
4,2,803,-37.86162,145.11042,1450000,2248000,737371648,798000,735921648
3,2,343,-37.86324,145.10289,1060000,2248000,372463552,1188000,371403552
3,2,612,-38.01596,145.09932,970000,2248000,585069632,1278000,584099632
3,1,561,-37.7528,144.85585,750000,2248000,542990400,1498000,542240400
5,2,577,-37.75261,144.85631,800000,2248000,559961088,1448000,559161088
5,4,742,-37.80218,145.10063,2400000,2248000,693703168,-152000,691303168
4,4,929,-37.79497,145.10538,1850000,2248000,840124928,398000,838274928
4,2,900,-38.05614,145.38464,670000,2248000,814222208,1578000,813552208
3,3,252,-37.98453,145.02659,1850000,2248000,302106912,398000,300256912
2,1,617,-37.7528,145.04444,906000,2248000,585996928,1342000,585090928
2,1,834,-37.91627,145.03892,410000,2248000,757507648,1838000,757097648
5,2,591,-37.92211,145.0466,1500000,2248000,571162304,748000,569662304
3,2,232,-37.83574,145.14866,874000,2248000,284765312,1374000,283891312
3,1,158,-37.78893,144.84652,560000,2248000,224498448,1688000,223938448
3,1,0,-37.6841,144.92818,450000,835500,99669200,385500,99219200
3,1,322,-37.75887,144.97326,1120000,2248000,354181920,1128000,353061920
2,1,196,-37.75815,144.97366,1110000,2248000,253238256,1138000,252128256
4,3,733,-37.759,144.96623,1790000,2248000,683543232,458000,681753232
1,1,0,-37.77883,144.9776,390500,835500,96978328,445000,96587828
5,2,627,-37.69264,145.0799,999000,2248000,599606528,1249000,598607528
2,1,0,-37.88415,145.0514,796000,835500,98402344,39500,97606344
3,1,184,-37.90017,145.05812,1050000,2248000,245189536,1198000,244139536
2,1,816,-37.86068,145.01121,610000,2248000,743258752,1638000,742648752
2,1,278,-38.04602,145.1191,639000,2248000,318166080,1609000,317527080
3,1,539,-37.97223,145.07895,1050000,2248000,525766880,1198000,524716880
2,2,533,-37.79443,144.99944,640000,2248000,521182368,1608000,520542368
3,1,579,-37.74482,144.97499,1285000,2248000,557288128,963000,556003128
2,1,0,-37.79589,144.98863,1080000,835500,98353344,-244500,97273344
3,2,654,-37.6038,144.9226,607500,2248000,618105024,1640500,617497524
3,2,448,-37.58242,144.93001,500000,2248000,455305472,1748000,454805472
3,2,350,-37.56883,144.90887,510000,2248000,377841600,1738000,377331600
4,2,448,-37.57635,144.91151,592500,2248000,456659648,1655500,456067148
3,1,713,-37.98997,145.2254,669000,2248000,663371136,1579000,662702136
5,2,779,-37.94465,145.21236,895000,2248000,719843200,1353000,718948200
4,2,344,-37.719,144.76699,505000,2248000,374396352,1743000,373891352
5,3,851,-37.78109,145.13745,1530000,2248000,778272640,718000,776742640
3,1,0,-37.78738,145.16033,816000,835500,99824216,19500,99008216
4,3,417,-37.79223,145.14606,1385000,2248000,433923328,863000,432538328
2,1,590,-37.99715,145.23526,472500,2248000,564805056,1775500,564332556
1,1,0,-37.81177,144.97617,895000,835500,96981320,-59500,96086320
2,1,224,-38.0371,145.11717,724000,2248000,275487744,1524000,274763744
3,2,458,-37.88148,145.00539,1975000,2248000,463290048,273000,461315048
3,1,1405,-37.88065,145.01112,1200000,2248000,1210113152,1048000,1208913152
2,1,637,-37.88374,144.98518,630000,2248000,601781824,1618000,601151824
3,1,811,-37.7384,144.90485,1535000,2248000,740593472,713000,739058472
2,1,779,-37.71532,144.96508,830000,2248000,713972160,1418000,713142160
3,1,968,-37.88523,145.28553,740000,2248000,864922048,1508000,864182048
2,1,1909,-37.79919,144.89607,430000,2248000,1606977152,1818000,1606547152
3,1,312,-37.79334,144.89128,900000,2248000,346232512,1348000,345332512
4,2,180,-37.79686,144.908,1000000,2248000,244883296,1248000,243883296
4,1,446,-37.79221,144.89076,891000,2248000,453498400,1357000,452607400
3,1,590,-37.84308,145.168,1011000,2248000,566111808,1237000,565100808
2,1,200,-37.85743,145.0468,580000,2248000,256456128,1668000,255876128
2,1,1101,-37.85724,145.04681,519500,2248000,968515328,1728500,967995828
2,1,345,-37.89919,145.14856,656000,2248000,371116992,1592000,370460992
5,2,650,-37.90383,145.17166,1182000,2248000,617864704,1066000,616682704
3,2,365,-37.88599,145.17031,1000000,2248000,389894304,1248000,388894304
2,1,201,-37.70691,144.90934,493000,2248000,257144096,1755000,256651096
3,2,627,-37.70198,144.92166,940000,2248000,596777920,1308000,595837920
2,1,144,-37.70628,144.92379,435000,2248000,212105904,1813000,211670904
4,1,652,-37.70542,144.95127,741000,2248000,616326976,1507000,615585976
3,1,325,-37.70325,144.94757,550000,2248000,356530496,1698000,355980496
3,2,220,-37.93487,145.00093,1405000,2248000,275202464,843000,273797464
4,2,801,-37.82734,145.24487,1270500,2248000,735869824,977500,734599324
3,1,693,-37.82536,145.24893,751000,2248000,647560256,1497000,646809256
4,2,719,-37.94999,145.03122,1535000,2248000,670948224,713000,669413224
4,2,788,-37.68974,144.75225,700000,2248000,725276480,1548000,724576480
3,1,609,-37.86991,144.68607,520000,2248000,580833920,1728000,580313920
4,2,680,-37.86821,144.69566,650000,2248000,639910336,1598000,639260336
2,1,0,-37.89369,145.08354,472000,835500,98423240,363500,97951240
2,1,229,-37.7651,145.03452,880000,2248000,279356384,1368000,278476384
4,3,181,-37.76758,145.03883,985000,2248000,247343920,1263000,246358920
3,1,588,-37.68306,144.90928,528000,2248000,564353152,1720000,563825152
3,2,669,-37.73936,144.85874,918000,2248000,629936192,1330000,629018192
2,1,0,-37.79413,145.02382,591000,835500,98374792,244500,97783792
3,2,543,-37.72765,144.78107,565000,2248000,530309312,1683000,529744312
4,2,685,-37.67277,144.59643,362000,2248000,643777792,1886000,643415792
3,1,535,-37.6615,145.02761,560000,2248000,522537568,1688000,521977568
3,1,230,-38.16404,145.18781,447000,2248000,281654112,1801000,281207112
3,1,523,-37.78242,144.86955,681000,2248000,512970880,1567000,512289880
3,1,653,-37.78639,144.88214,1005000,2248000,615717952,1243000,614712952
2,1,312,-37.78353,144.87233,468000,2248000,344853504,1780000,344385504
3,2,91,-37.77449,144.88011,640000,2248000,173160688,1608000,172520688
3,1,658,-37.64821,144.92527,420000,2248000,619679744,1828000,619259744
3,1,611,-37.69467,144.57827,326000,2248000,582327680,1922000,582001680
3,2,602,-37.66916,145.06912,725000,2248000,577107264,1523000,576382264
3,1,774,-37.80588,145.1981,1101000,2248000,711540928,1147000,710439928
4,3,374,-37.81521,145.18727,926000,2248000,399968608,1322000,399042608
1,1,0,-37.77149,144.91552,362000,835500,96939256,473500,96577256
1,1,57,-38.00331,145.09425,309000,2248000,142123536,1939000,141814536
2,1,161,-37.8837,145.11526,611000,2248000,225679680,1637000,225068680
3,2,197,-37.92285,145.18549,755000,2248000,257137760,1493000,256382760
3,2,246,-37.92829,145.19647,862000,2248000,295869792,1386000,295007792
3,2,434,-37.93228,145.15827,815500,2248000,444422944,1432500,443607444
3,2,449,-37.84769,144.87667,1100000,2248000,456094176,1148000,454994176
4,2,650,-37.73435,144.8768,1130000,2248000,616297216,1118000,615167216
4,2,270,-37.74266,144.88577,1006000,2248000,315990112,1242000,314984112
2,1,197,-37.96903,145.18999,445000,2248000,254186464,1803000,253741464
3,1,603,-37.96318,145.18962,650000,2248000,576413120,1598000,575763120
2,1,0,-37.79831,144.94261,465000,835500,98325288,370500,97860288
3,1,390,-37.76588,144.99731,1335000,2248000,407937888,913000,406602888
4,2,558,-37.91917,145.08807,1390000,2248000,543741440,858000,542351440
4,2,600,-38.07583,145.43698,643500,2248000,577167168,1604500,576523668
2,1,129,-37.71865,144.95018,510000,2248000,200269104,1738000,199759104
2,1,164,-37.72219,144.92559,550000,2248000,227914848,1698000,227364848
2,1,103,-37.72773,144.92628,580000,2248000,179707712,1668000,179127712
1,1,631,-37.74495,144.99322,250000,2248000,595662464,1998000,595412464
1,1,629,-37.74144,144.99326,392000,2248000,594081536,1856000,593689536
1,1,102,-37.74679,145.01394,505000,2248000,177607408,1743000,177102408
3,1,397,-37.73724,145.00984,980000,2248000,413474336,1268000,412494336
2,1,89,-37.71766,145.00132,320000,2248000,168688544,1928000,168368544
2,2,0,-37.73012,145.02652,617500,835500,99962200,218000,99344700
5,2,499,-37.72556,144.99021,1282500,2248000,498397024,965500,497114524
2,1,3512,-37.81828,144.99789,419000,2248000,2873891072,1829000,2873472072
2,2,92,-37.82324,144.99174,1667500,2248000,172659200,580500,170991700
2,2,0,-37.813,144.99303,685000,835500,99951328,150500,99266328
3,2,918,-37.794,145.24636,882500,2248000,826965568,1365500,826083068
3,2,651,-37.79638,145.24268,910000,2248000,615953728,1338000,615043728
3,2,390,-37.95035,145.01571,1651000,2248000,409564160,597000,407913160
4,2,1134,-37.89496,145.23404,1040000,2248000,999040512,1208000,998000512
4,2,960,-37.88992,145.22123,1120000,2248000,861520128,1128000,860400128
3,2,330,-37.64027,145.08745,500000,2248000,362153952,1748000,361653952
1,1,0,-37.83547,144.98844,420000,835500,96991656,415500,96571656
2,2,0,-37.83863,144.99379,460000,835500,99954808,375500,99494808
2,2,0,-37.84018,145.00265,1340000,835500,99960448,-504500,98620448
3,1,638,-37.98031,145.15497,700000,2248000,604054208,1548000,603354208
1,1,0,-37.87223,144.98046,360000,835500,96991056,475500,96631056
4,1,750,-37.73051,144.91731,1220000,2248000,693758272,1028000,692538272
3,1,678,-37.56935,144.7241,500000,2248000,635352704,1748000,634852704
3,1,606,-37.57532,144.71058,438000,2248000,578443584,1810000,578005584
4,2,283,-37.76508,144.83629,650000,2248000,326236160,1598000,325586160
3,2,358,-37.79573,144.79311,615000,2248000,384119392,1633000,383504392
4,2,1017,-37.69106,144.75854,740000,2248000,906259008,1508000,905519008
4,2,371,-37.867,144.65618,463500,2248000,395683584,1784500,395220084
3,2,400,-37.83353,144.67324,530000,2248000,417242592,1718000,416712592
3,2,326,-37.85037,144.66179,446000,2248000,358755456,1802000,358309456
3,2,389,-37.71364,144.76031,520000,2248000,408588864,1728000,408068864
3,2,343,-37.7117,144.75204,530000,2248000,372229760,1718000,371699760
5,3,450,-37.71152,144.75283,725500,2248000,461117920,1522500,460392420
3,2,198,-37.69503,144.77869,502000,2248000,257650896,1746000,257148896
4,2,729,-37.76846,145.11183,1215000,2248000,678879488,1033000,677664488
2,1,217,-37.75671,145.11401,731000,2248000,269920736,1517000,269189736
3,1,526,-37.68164,144.99769,651000,2248000,515408832,1597000,514757832
3,1,584,-37.6819,145.02294,631000,2248000,561261760,1617000,560630760
3,1,396,-37.75358,144.98534,1110000,2248000,412670848,1138000,411560848
2,1,0,-37.83241,145.00705,735000,835500,98368968,100500,97633968
3,1,778,-37.70321,144.87972,822000,2248000,714494016,1426000,713672016
3,1,653,-37.84034,145.2022,988000,2248000,615921216,1260000,614933216
3,1,169,-37.87345,145.22973,630000,2248000,233437552,1618000,232807552
3,1,598,-37.717,145.08891,830000,2248000,572370688,1418000,571540688
3,1,600,-37.69872,145.08743,710000,2248000,573948160,1538000,573238160
3,1,548,-37.8889,144.65744,383000,2248000,532610368,1865000,532227368
4,2,358,-37.91807,144.63816,463000,2248000,385404640,1785000,384941640
3,1,567,-37.88666,144.66149,452000,2248000,547628288,1796000,547176288
4,2,520,-37.91859,144.64143,665000,2248000,513435104,1583000,512770104
3,1,633,-37.89444,144.65591,485000,2248000,599785408,1763000,599300408
4,2,531,-37.89556,144.64268,510000,2248000,522126464,1738000,521616464
3,1,269,-37.79638,144.87911,850000,2248000,312242592,1398000,311392592
4,2,240,-37.85414,144.89561,1440000,2248000,292300352,808000,290860352
3,2,863,-37.65391,145.37389,620000,2248000,783561152,1628000,782941152
2,1,463,-37.82333,144.87955,900000,2248000,464197760,1348000,463297760
4,2,446,-37.81845,144.87464,1407000,2248000,455084768,841000,453677768
3,2,195,-37.7325,144.88272,780000,2248000,255348432,1468000,254568432
3,1,566,-37.74306,144.76679,555000,2248000,546885888,1693000,546330888
3,2,175,-37.77856,144.82443,580000,2248000,239511968,1668000,238931968
3,1,697,-37.77713,144.79746,627000,2248000,650437888,1621000,649810888
4,2,668,-37.86096,145.10026,1540000,2248000,630674944,708000,629134944
5,4,729,-37.806,145.09511,3812000,2248000,683426304,-1564000,679614304
4,2,605,-37.79466,145.06564,1755000,2248000,580856960,493000,579101960
3,1,424,-37.84291,145.25545,606000,2248000,434975968,1642000,434369968
3,3,307,-37.91648,145.04927,1435000,2248000,345579296,813000,344144296
3,2,669,-37.91289,145.08065,1260000,2248000,630093120,988000,628833120
3,1,792,-38.03517,145.33886,620000,2248000,725879808,1628000,725259808
2,1,0,-37.97853,145.0175,600000,835500,98392568,235500,97792568
2,1,3316,-37.8321,145.14444,615000,2248000,2719084032,1633000,2718469032
4,2,723,-37.8476,145.29493,770000,2248000,674259648,1478000,673489648
2,1,100,-37.89569,144.99881,845000,2248000,177401200,1403000,176556200
4,1,752,-37.67641,144.91435,706000,2248000,695330624,1542000,694624624
4,2,576,-37.69104,144.54532,456000,2248000,557605888,1792000,557149888
2,1,108,-37.75715,144.96824,650000,2248000,183688496,1598000,183038496
2,1,123,-37.7784,144.97404,620000,2248000,195549024,1628000,194929024
2,1,0,-37.77818,144.97412,683000,835500,98342320,152500,97659320
2,1,71,-37.77169,144.97557,501000,2248000,154453648,1747000,153952648
2,1,0,-37.77887,144.97797,615000,835500,98344776,220500,97729776
2,1,539,-37.77279,144.94069,1150000,2248000,524292096,1098000,523142096
3,2,347,-37.85377,145.15512,835000,2248000,375655744,1413000,374820744
3,2,316,-37.76048,144.78847,640000,2248000,350919872,1608000,350279872
3,2,186,-37.84143,145.08705,1280000,2248000,248374336,968000,247094336
4,2,947,-37.84403,145.09545,2500000,2248000,851163392,-252000,848663392
2,1,1625,-37.84237,145.09257,600800,2248000,1382658304,1647200,1382057504
3,2,259,-37.89178,145.0539,1151000,2248000,306051648,1097000,304900648
3,2,379,-38.07912,145.12965,625000,2248000,400956128,1623000,400331128
3,1,528,-38.09798,145.18737,480000,2248000,517155104,1768000,516675104
5,2,276,-37.87883,145.09741,1050000,2248000,322244384,1198000,321194384
5,5,570,-38.03335,145.13212,835500,2248000,559411584,1412500,558576084
4,2,721,-37.9641,145.06547,1740000,2248000,672551552,508000,670811552
2,1,0,-37.78791,145.00588,591000,835500,98363016,244500,97772016
4,2,426,-37.74892,144.95759,1400000,2248000,439321664,848000,437921664
2,1,476,-37.73883,144.95321,996000,2248000,474507040,1252000,473511040
4,2,500,-37.72165,144.95853,1011000,2248000,497801120,1237000,496790120
3,2,275,-37.73156,144.97087,830000,2248000,318626464,1418000,317796464
4,2,336,-37.59392,144.89956,510000,2248000,368140864,1738000,367630864
4,2,512,-37.58505,144.93592,590000,2248000,507254784,1658000,506664784
3,1,301,-37.58739,144.92619,390000,2248000,337536576,1858000,337146576
4,2,579,-38.07202,145.27369,500000,2248000,560469952,1748000,559969952
3,1,721,-37.79244,145.12021,1420000,2248000,669605440,828000,668185440
3,1,660,-37.77859,145.15755,1460000,2248000,621418688,788000,619958688
3,1,585,-37.99608,145.23587,450000,2248000,562220032,1798000,561770032
2,1,538,-37.88295,145.00083,834500,2248000,523551776,1413500,522717276
4,3,1503,-37.70697,145.14105,920000,2248000,1292174976,1328000,1291254976
2,1,837,-37.87307,144.98635,930000,2248000,759841088,1318000,758911088
2,1,797,-37.87449,144.99059,720000,2248000,728231872,1528000,727511872
3,2,0,-37.87472,144.98235,1035000,835500,101318208,-199500,100283208
2,1,795,-37.88351,144.99202,715000,2248000,726653248,1533000,725938248
2,1,1000,-37.93064,145.4453,655000,2248000,888948992,1593000,888293992
3,2,581,-37.98418,145.27178,630000,2248000,560672832,1618000,560042832
3,2,810,-37.98841,145.26001,676000,2248000,741644480,1572000,740968480
4,2,571,-37.63762,145.03539,658000,2248000,553949760,1590000,553291760
3,2,321,-37.63169,145.03135,500000,2248000,355005728,1748000,354505728
3,2,390,-37.62882,145.00979,560000,2248000,409522752,1688000,408962752
2,2,214,-37.65151,145.02815,503000,2248000,269077920,1745000,268574920
3,1,697,-37.77662,145.02288,1800000,2248000,650576640,448000,648776640
3,2,720,-37.87768,145.25918,861000,2248000,670504064,1387000,669643064
4,2,659,-37.89508,145.27879,890000,2248000,623676096,1358000,622786096
2,1,0,-37.80474,144.9021,370000,835500,98301112,465500,97931112
4,2,767,-38.16147,145.14285,680000,2248000,708976064,1568000,708296064
3,1,632,-38.11984,145.16209,570000,2248000,599333184,1678000,598763184
4,2,694,-38.16227,145.1208,945000,2248000,651270720,1303000,650325720
2,1,0,-37.88937,145.04038,450000,835500,98396168,385500,97946168
2,1,197,-37.85448,145.0485,955000,2248000,254085936,1293000,253130936
3,1,650,-37.70768,144.92586,820000,2248000,613364800,1428000,612544800
3,1,422,-37.70425,144.93164,680000,2248000,433179744,1568000,432499744
4,2,789,-37.69646,145.12163,770000,2248000,726294912,1478000,725524912
4,3,807,-37.70077,145.12743,900000,2248000,742117632,1348000,741217632
3,2,161,-37.74897,145.07024,835000,2248000,228595616,1413000,227760616
3,1,269,-37.94775,145.02379,1200000,2248000,312349376,1048000,311149376
3,2,240,-37.9461,145.02432,1030000,2248000,291024128,1218000,289994128
4,2,304,-37.94633,145.04947,1200000,2248000,342984992,1048000,341784992
2,1,591,-37.94763,145.02717,1150000,2248000,565461504,1098000,564311504
4,2,542,-37.68104,144.74608,618350,2248000,530858208,1629650,530239858
3,2,580,-37.87447,144.66771,540000,2248000,559497856,1708000,558957856
4,2,637,-37.77671,145.04005,2530000,2248000,606128768,-282000,603598768
3,2,761,-37.72224,144.85739,750000,2248000,702640768,1498000,701890768
5,3,650,-37.72285,144.86073,765000,2248000,619245376,1483000,618480376
3,2,325,-37.81614,145.05056,1405000,2248000,358200448,843000,356795448
4,2,813,-37.80437,145.01725,3015000,2248000,745210496,-767000,742195496
3,1,540,-37.9884,145.15925,745000,2248000,526608544,1503000,525863544
3,2,637,-37.66195,144.59785,375000,2248000,604476864,1873000,604101864
2,1,277,-37.66612,145.0008,444000,2248000,317258304,1804000,316814304
3,1,534,-37.67024,145.03644,544000,2248000,521753792,1704000,521209792
3,1,532,-37.66101,145.02568,580500,2248000,520165376,1667500,519584876
3,2,159,-37.78502,144.86733,670000,2248000,226894368,1578000,226224368
4,3,294,-37.78133,144.86768,821000,2248000,336544000,1427000,335723000
3,1,154,-37.64992,144.91883,360000,2248000,221365440,1888000,221005440
3,1,670,-37.65168,144.91868,510000,2248000,629159744,1738000,628649744
2,1,89,-37.80802,144.96168,565000,2248000,168674752,1683000,168109752
3,1,670,-37.70228,144.57688,385000,2248000,628955264,1863000,628570264
4,1,865,-37.67396,144.55784,427500,2248000,784414720,1820500,783987220
3,2,555,-37.6764,145.05085,668000,2248000,539952896,1580000,539284896
3,2,661,-37.66898,145.07209,650000,2248000,623736768,1598000,623086768
4,2,375,-37.76261,144.93249,1400000,2248000,399002592,848000,397602592
3,1,886,-37.7753,145.31266,696000,2248000,800121344,1552000,799425344
3,2,660,-37.86198,145.139,1406000,2248000,623010304,842000,621604304
3,1,744,-37.93168,145.16126,9000000,2248000,687824064,-6752000,678824064
3,1,727,-37.9128,145.16152,1001000,2248000,674386944,1247000,673385944
2,1,80,-37.89563,145.06992,540000,2248000,161638992,1708000,161098992
2,1,402,-37.89801,145.07104,910000,2248000,416116192,1338000,415206192
1,1,0,-37.89022,145.07333,295000,835500,97050344,540500,96755344
2,1,963,-37.84212,144.88211,582000,2248000,859350912,1666000,858768912
3,1,671,-37.962,145.18035,695000,2248000,630147520,1553000,629452520
4,1,318,-37.7631,144.99884,1515000,2248000,352403200,733000,350888200
3,2,266,-37.82923,145.1744,813000,2248000,311650560,1435000,310837560
2,1,0,-37.71652,144.92268,545000,835500,98303416,290500,97758416
4,2,866,-37.71979,144.92341,1300000,2248000,787028736,948000,785728736
4,2,656,-37.71652,144.91211,1260000,2248000,621058560,988000,619798560
3,1,559,-37.7327,144.92966,940000,2248000,541452864,1308000,540512864
4,2,448,-37.91269,144.73946,620000,2248000,456593216,1628000,455973216
2,1,101,-37.83446,144.94021,1722500,2248000,178148224,525500,176425724
4,1,509,-37.74684,144.9933,1485000,2248000,503344928,763000,501859928
2,1,243,-37.71045,145.0018,672000,2248000,290394016,1576000,289722016
1,1,0,-37.81317,145.00834,330000,835500,97001288,505500,96671288
3,2,941,-37.81289,145.24213,1400000,2248000,845142016,848000,843742016
2,1,1453,-37.87827,144.99752,558500,2248000,1246672640,1689500,1246114140
3,2,266,-37.63544,144.93274,460000,2248000,311479040,1788000,311019040
3,2,400,-37.62584,144.92506,490000,2248000,417373184,1758000,416883184
4,2,390,-37.96,145.02068,1660000,2248000,410934528,588000,409274528
4,2,404,-37.95882,145.02138,1235000,2248000,421999008,1013000,420764008
4,2,771,-38.10052,145.13397,870000,2248000,712124672,1378000,711254672
4,2,535,-38.09683,145.12981,880000,2248000,525611168,1368000,524731168
2,1,126,-37.80473,144.89095,945000,2248000,197871872,1303000,196926872
3,2,340,-37.83172,144.86683,730000,2248000,369943648,1518000,369213648
2,1,64,-37.83326,144.95464,980000,2248000,148915920,1268000,147935920
2,1,0,-37.84679,145.00206,570000,835500,98367584,265500,97797584
2,1,0,-37.85911,144.979,600000,835500,98354840,235500,97754840
2,1,143,-37.57063,144.70693,360000,2248000,211166192,1888000,210806192
3,1,754,-37.58442,144.75565,475000,2248000,695436544,1773000,694961544
3,2,563,-37.57499,144.75329,495000,2248000,546080192,1753000,545585192
3,1,694,-37.78871,144.81369,695000,2248000,648078400,1553000,647383400
3,1,1143,-37.79135,144.79948,760000,2248000,1002914176,1488000,1002154176
3,1,672,-37.80118,144.80996,583500,2248000,630690944,1664500,630107444
3,2,662,-37.70525,144.75699,585000,2248000,624337408,1663000,623752408
3,2,779,-37.76311,145.10494,1245000,2248000,717023296,1003000,715778296
6,3,1054,-37.77404,145.11703,2000000,2248000,940056128,248000,938056128
2,1,140,-37.68199,145.01744,407000,2248000,208999504,1841000,208592504
3,2,199,-37.75948,144.99615,891000,2248000,258582608,1357000,257691608
3,2,238,-37.70322,144.88236,615500,2248000,289327616,1632500,288712116
2,1,0,-37.69815,144.88019,300000,835500,98275104,535500,97975104
5,3,818,-37.87846,145.24212,1310000,2248000,752268544,938000,750958544
4,2,555,-37.89359,144.66911,645000,2248000,541109632,1603000,540464632
4,2,533,-37.89337,144.64003,482500,2248000,523705120,1765500,523222620
3,2,287,-37.87895,144.6707,394000,2248000,327942624,1854000,327548624
4,3,544,-37.67841,144.87924,821000,2248000,534113728,1427000,533292728
3,2,691,-37.68026,144.88468,635000,2248000,647331648,1613000,646696648
3,2,972,-37.51232,145.13282,601000,2248000,869538688,1647000,868937688
3,1,179,-37.86558,144.90474,1050000,2248000,241139584,1198000,240089584
1,1,0,-37.85588,144.89936,385000,835500,96939224,450500,96554224
2,1,0,-37.85581,144.99025,560000,835500,98361368,275500,97801368
6,3,1087,-37.81038,144.89389,2450000,2248000,966002944,-202000,963552944
,,,,,,,TOTAL ERROR,1050743.502,471713856.7
